jugador,Pos,Age,Tm,G,GS,MP,FG,FGA,FG%,3P,3PA,3P%,2P,2PA,2P%,eFG%,FT,FTA,FT%,ORB,DRB,TRB,AST,STL,BLK,TOV,PF,PTS
Precious Achiuwa,C,22,TOR,73,28,1725,265,603,0.439,56,156,0.359,209,447,0.468,0.486,78,131,0.595,146,327,473,82,37,41,84,151,664
Steven Adams,C,28,MEM,76,75,1999,210,384,0.547,0,1,0,210,383,0.548,0.547,108,199,0.543,349,411,760,256,65,60,115,153,528
Bam Adebayo,C,24,MIA,56,56,1825,406,729,0.557,0,6,0,406,723,0.562,0.557,256,340,0.753,137,427,564,190,80,44,148,171,1068
Santi Aldama,PF,21,MEM,32,0,360,53,132,0.402,6,48,0.125,47,84,0.56,0.424,20,32,0.625,33,54,87,21,6,10,16,36,132
LaMarcus Aldridge,C,36,BRK,47,12,1050,252,458,0.55,14,46,0.304,238,412,0.578,0.566,89,102,0.873,73,185,258,42,14,47,44,78,607
Nickeil Alexander-Walker,SG,23,TOT,65,21,1466,253,680,0.372,105,338,0.311,148,342,0.433,0.449,81,109,0.743,37,150,187,156,46,23,93,103,692
Grayson Allen,SG,26,MIL,66,61,1805,255,569,0.448,159,389,0.409,96,180,0.533,0.588,64,74,0.865,32,190,222,100,46,18,43,96,733
Jarrett Allen,C,23,CLE,56,56,1809,369,545,0.677,1,10,0.1,368,535,0.688,0.678,165,233,0.708,192,410,602,92,44,75,94,97,904
Jose Alvarado,PG,23,NOP,54,1,834,131,294,0.446,32,110,0.291,99,184,0.538,0.5,36,53,0.679,25,75,100,152,71,7,40,73,330
Justin Anderson,SF,28,TOT,16,6,316,36,95,0.379,15,59,0.254,21,36,0.583,0.458,15,19,0.789,4,42,46,33,8,6,8,22,102
Kyle Anderson,PF,28,MEM,69,11,1484,209,469,0.446,36,109,0.33,173,360,0.481,0.484,67,105,0.638,69,299,368,183,77,45,71,108,521
Giannis Antetokounmpo,PF,27,MIL,67,67,2204,689,1245,0.553,71,242,0.293,618,1003,0.616,0.582,553,766,0.722,134,644,778,388,72,91,219,212,2002
Thanasis Antetokounmpo,SF,29,MIL,48,6,473,70,128,0.547,2,14,0.143,68,114,0.596,0.555,29,46,0.63,40,61,101,22,16,12,26,68,171
Carmelo Anthony,PF,37,LAL,69,3,1793,319,723,0.441,149,397,0.375,170,326,0.521,0.544,132,159,0.83,62,226,288,68,47,52,59,166,919
Cole Anthony,PG,21,ORL,65,65,2059,357,912,0.391,132,391,0.338,225,521,0.432,0.464,216,253,0.854,32,316,348,369,46,17,170,171,1062
OG Anunoby,SF,24,TOR,48,48,1728,309,697,0.443,115,317,0.363,194,380,0.511,0.526,89,118,0.754,74,190,264,125,71,25,80,131,822
Ryan Arcidiacono,PG,27,NYK,10,0,76,6,12,0.5,4,9,0.444,2,3,0.667,0.667,0,0,0,0,8,8,4,1,0,3,5,16
Trevor Ariza,SF,36,LAL,24,11,462,33,99,0.333,20,74,0.27,13,25,0.52,0.434,10,18,0.556,10,72,82,27,13,6,11,20,96
D.J. Augustin,PG,34,TOT,55,2,883,94,222,0.423,68,164,0.415,26,58,0.448,0.577,38,43,0.884,11,57,68,107,17,1,56,39,294
Deni Avdija,SF,21,WAS,82,8,1984,250,579,0.432,82,259,0.317,168,320,0.525,0.503,103,136,0.757,52,373,425,167,59,44,87,190,685
Joel Ayayi,SG,21,WAS,7,0,20,1,6,0.167,0,1,0,1,5,0.2,0.167,0,0,0,1,2,3,4,0,0,0,0,2
Deandre Ayton,C,23,PHO,58,58,1713,442,697,0.634,7,19,0.368,435,678,0.642,0.639,106,142,0.746,149,444,593,84,40,40,91,142,997
Udoka Azubuike,C,22,UTA,17,6,195,37,49,0.755,0,0,0,37,49,0.755,0.755,6,11,0.545,18,53,71,0,1,11,12,25,80
Marvin Bagley III,PF,22,TOT,48,25,1146,225,446,0.504,23,97,0.237,202,349,0.579,0.53,67,101,0.663,105,233,338,36,22,18,39,93,540
LaMelo Ball,PG,20,CHO,75,75,2422,538,1254,0.429,220,565,0.389,318,689,0.462,0.517,212,243,0.872,108,393,501,571,119,30,245,237,1508
Lonzo Ball,PG,24,CHI,35,35,1212,162,383,0.423,110,260,0.423,52,123,0.423,0.567,21,28,0.75,35,155,190,178,64,31,82,85,455
Mo Bamba,C,23,ORL,71,69,1824,296,617,0.48,107,281,0.381,189,336,0.563,0.566,57,73,0.781,148,424,572,85,38,118,77,182,756
Desmond Bane,SG,23,MEM,76,76,2266,508,1101,0.461,228,523,0.436,280,578,0.484,0.565,140,155,0.903,46,288,334,208,92,29,111,196,1384
Dalano Banton,PG,22,TOR,64,1,696,83,202,0.411,13,51,0.255,70,151,0.464,0.443,26,44,0.591,38,86,124,99,28,10,53,68,205
Cat Barber,PG,27,ATL,3,0,13,0,4,0,0,0,0,0,4,0,0,0,4,0,1,2,3,3,0,0,1,1,0
Harrison Barnes,PF,29,SAC,77,77,2587,391,834,0.469,142,360,0.394,249,474,0.525,0.554,341,413,0.826,82,350,432,186,53,14,118,94,1265
Scottie Barnes,PF,20,TOR,74,74,2617,459,932,0.492,58,193,0.301,401,739,0.543,0.524,158,215,0.735,195,362,557,256,80,55,136,192,1134
RJ Barrett,SF,21,NYK,70,70,2417,487,1194,0.408,138,404,0.342,349,790,0.442,0.466,290,406,0.714,66,342,408,208,43,16,151,142,1402
Will Barton,SG,31,DEN,71,71,2277,392,896,0.438,157,430,0.365,235,466,0.504,0.525,102,127,0.803,44,296,340,276,55,31,127,114,1043
Paris Bass,SF,26,PHO,2,0,7,2,6,0.333,0,2,0,2,4,0.5,0.333,2,2,1,2,2,4,0,1,0,2,2,6
Charles Bassey,C,21,PHI,23,0,168,30,47,0.638,0,4,0,30,43,0.698,0.638,9,12,0.75,22,40,62,7,5,17,8,32,69
Keita Bates-Diop,SF,26,SAS,59,14,956,136,263,0.517,17,55,0.309,119,208,0.572,0.549,46,61,0.754,62,169,231,41,27,14,45,61,335
Nicolas Batum,PF,33,LAC,59,54,1462,179,387,0.463,108,270,0.4,71,117,0.607,0.602,25,38,0.658,29,225,254,100,58,42,40,80,491
Kent Bazemore,SF,32,LAL,39,14,545,45,139,0.324,29,80,0.363,16,59,0.271,0.428,13,17,0.765,13,56,69,34,25,9,21,70,132
Darius Bazley,PF,21,OKC,69,53,1924,274,649,0.422,80,269,0.297,194,380,0.511,0.484,117,170,0.688,71,365,436,97,58,70,90,68,745
Bradley Beal,SG,28,WAS,40,40,1439,348,771,0.451,63,210,0.3,285,561,0.508,0.492,169,203,0.833,38,151,189,265,36,15,135,95,928
Malik Beasley,SG,25,MIN,79,18,1976,332,850,0.391,240,637,0.377,92,213,0.432,0.532,49,60,0.817,26,201,227,116,43,12,43,88,953
Jordan Bell,C,27,CHI,1,0,2,0,0,0,0,0,0,0,0,0,0,0,0,0,1,0,1,0,1,0,0,2,0
DeAndre' Bembry,SF,27,TOT,56,20,1026,124,221,0.561,15,36,0.417,109,185,0.589,0.595,21,35,0.6,42,121,163,66,49,25,31,113,284
Dāvis Bertāns,PF,29,TOT,56,0,807,99,275,0.36,77,230,0.335,22,45,0.489,0.5,36,40,0.9,12,105,117,31,17,12,19,85,311
Patrick Beverley,PG,33,MIN,58,54,1476,177,436,0.406,83,242,0.343,94,194,0.485,0.501,96,133,0.722,62,178,240,268,67,52,73,174,533
Saddiq Bey,SF,22,DET,82,82,2704,450,1136,0.396,211,610,0.346,239,526,0.454,0.489,210,254,0.827,107,334,441,233,73,16,96,128,1321
Khem Birch,C,29,TOR,55,28,991,97,200,0.485,0,14,0,97,186,0.522,0.485,53,71,0.746,122,117,239,56,30,26,29,104,247
Goga Bitadze,C,22,IND,50,16,729,131,252,0.52,23,80,0.288,108,172,0.628,0.565,64,94,0.681,79,98,177,55,21,42,46,107,349
Bismack Biyombo,C,29,PHO,36,3,506,86,145,0.593,0,0,0,86,145,0.593,0.593,38,71,0.535,63,104,167,23,12,26,25,70,210
Nemanja Bjelica,C,33,GSW,71,0,1142,160,342,0.468,54,149,0.362,106,193,0.549,0.547,59,81,0.728,62,232,294,159,41,26,87,128,433
Eric Bledsoe,PG,32,LAC,54,29,1361,197,468,0.421,51,163,0.313,146,305,0.479,0.475,89,117,0.761,28,154,182,225,69,19,116,85,534
Keljin Blevins,SF,26,POR,31,1,349,34,111,0.306,21,72,0.292,13,39,0.333,0.401,6,11,0.545,16,29,45,19,13,1,17,29,95
Bogdan Bogdanović,SG,29,ATL,63,27,1848,342,794,0.431,169,459,0.368,173,335,0.516,0.537,97,115,0.843,29,221,250,194,68,14,70,132,950
Bojan Bogdanović,PF,32,UTA,69,69,2131,422,928,0.455,181,468,0.387,241,460,0.524,0.552,223,260,0.858,58,238,296,120,34,1,118,116,1248
Bol Bol,PF,22,DEN,14,0,81,15,27,0.556,1,4,0.25,14,23,0.609,0.574,2,5,0.4,4,16,20,5,1,2,4,4,33
Leandro Bolmaro,SF,21,MIN,35,2,241,17,54,0.315,5,18,0.278,12,36,0.333,0.361,11,13,0.846,16,27,43,21,6,0,13,26,50
Isaac Bonga,SF,22,TOR,15,0,69,3,13,0.231,1,4,0.25,2,9,0.222,0.269,5,8,0.625,4,3,7,4,8,2,2,10,12
Devin Booker,SG,25,PHO,68,68,2345,662,1421,0.466,183,478,0.383,479,943,0.508,0.53,315,363,0.868,45,297,342,329,77,26,162,180,1822
Brandon Boston Jr.,SG,20,LAC,51,0,760,125,325,0.385,34,111,0.306,91,214,0.425,0.437,59,72,0.819,17,94,111,51,26,13,31,43,343
Chris Boucher,SF,29,TOR,80,9,1690,268,577,0.464,68,229,0.297,200,348,0.575,0.523,150,193,0.777,179,315,494,25,49,75,42,174,754
James Bouknight,SG,21,CHO,31,0,304,49,141,0.348,17,49,0.347,32,92,0.348,0.408,27,31,0.871,22,30,52,26,7,1,15,29,142
Avery Bradley,SG,31,LAL,62,45,1406,148,350,0.423,82,210,0.39,66,140,0.471,0.54,16,18,0.889,31,105,136,47,53,9,38,118,394
Tony Bradley,C,24,CHI,55,7,549,72,123,0.585,0,0,0,72,123,0.585,0.585,19,29,0.655,67,119,186,27,10,33,34,62,163
Ignas Brazdeikis,SF,23,ORL,42,1,536,81,188,0.431,27,87,0.31,54,101,0.535,0.503,21,32,0.656,23,49,72,37,10,3,17,48,210
Mikal Bridges,SF,25,PHO,82,82,2854,458,858,0.534,115,312,0.369,343,546,0.628,0.601,131,157,0.834,74,273,347,185,96,36,68,150,1162
Miles Bridges,PF,23,CHO,80,80,2837,596,1214,0.491,154,465,0.331,442,749,0.59,0.554,267,333,0.802,90,469,559,300,74,67,150,193,1613
Oshae Brissett,SF,23,IND,67,25,1564,208,506,0.411,83,237,0.35,125,269,0.465,0.493,114,164,0.695,108,250,358,72,44,29,54,116,613
Malcolm Brogdon,PG,29,IND,36,36,1206,243,543,0.448,58,186,0.312,185,357,0.518,0.501,143,167,0.856,33,152,185,212,30,14,77,71,687
Armoni Brooks,SG-PG,23,TOT,54,11,844,98,289,0.339,74,249,0.297,24,40,0.6,0.467,18,21,0.857,20,83,103,62,28,11,27,74,288
Dillon Brooks,SF,26,MEM,32,31,885,227,526,0.432,46,149,0.309,181,377,0.48,0.475,90,106,0.849,29,73,102,88,36,8,50,105,590
Bruce Brown,SF,25,BRK,72,45,1774,256,506,0.506,38,94,0.404,218,412,0.529,0.543,97,128,0.758,100,245,345,148,77,52,56,176,647
Charlie Brown Jr.,SG,24,TOT,22,2,177,10,39,0.256,1,12,0.083,9,27,0.333,0.269,9,10,0.9,14,18,32,6,10,4,5,18,30
Chaundee Brown Jr.,SG-SF,23,TOT,5,2,104,10,32,0.313,6,18,0.333,4,14,0.286,0.406,5,6,0.833,1,15,16,4,2,0,1,7,31
Greg Brown III,SF,20,POR,48,6,640,81,190,0.426,19,61,0.311,62,129,0.481,0.476,44,65,0.677,38,97,135,35,26,24,36,90,225
Jaylen Brown,SF,25,BOS,66,66,2220,576,1217,0.473,166,464,0.358,410,753,0.544,0.541,241,318,0.758,53,351,404,231,70,18,178,163,1559
Moses Brown,C,22,TOT,40,6,345,64,108,0.593,0,0,0,64,108,0.593,0.593,43,72,0.597,39,96,135,1,7,16,20,53,171
Sterling Brown,SG,26,DAL,49,3,628,59,155,0.381,28,92,0.304,31,63,0.492,0.471,14,15,0.933,26,123,149,34,14,7,23,56,160
Troy Brown Jr.,SF,22,CHI,66,7,1055,108,258,0.419,47,133,0.353,61,125,0.488,0.51,20,26,0.769,39,164,203,66,36,5,26,62,283
Jalen Brunson,SG,25,DAL,79,61,2524,506,1008,0.502,94,252,0.373,412,756,0.545,0.549,179,213,0.84,43,266,309,377,66,3,124,151,1285
Thomas Bryant,C,24,WAS,27,9,439,77,148,0.52,12,42,0.286,65,106,0.613,0.561,35,40,0.875,26,82,108,23,6,21,19,43,201
Shaq Buchanan,SG,25,MEM,2,0,10,1,4,0.25,0,2,0,1,2,0.5,0.25,0,0,0,1,1,2,2,1,0,2,1,2
Reggie Bullock,SF,30,DAL,68,37,1902,201,501,0.401,141,392,0.36,60,109,0.55,0.542,40,48,0.833,33,208,241,83,41,14,40,111,583
Trey Burke,PG,29,DAL,42,0,441,84,215,0.391,26,82,0.317,58,133,0.436,0.451,20,23,0.87,4,29,33,57,12,0,26,39,214
Alec Burks,SG,30,NYK,81,44,2318,285,728,0.391,157,389,0.404,128,339,0.378,0.499,217,264,0.822,47,350,397,239,85,26,91,215,944
Jared Butler,SG,21,UTA,42,1,360,61,151,0.404,28,88,0.318,33,63,0.524,0.497,11,16,0.688,5,40,45,63,17,8,33,47,161
Jimmy Butler,SF,32,MIA,57,57,1931,398,829,0.48,27,116,0.233,371,713,0.52,0.496,396,455,0.87,102,234,336,312,94,27,121,88,1219
Devontae Cacok,PF,25,SAS,15,0,121,21,31,0.677,0,0,0,21,31,0.677,0.677,4,7,0.571,8,34,42,6,8,7,3,16,46
Kentavious Caldwell-Pope,SG,28,WAS,77,77,2329,361,829,0.435,159,408,0.39,202,421,0.48,0.531,137,154,0.89,41,220,261,145,83,26,97,139,1018
Facundo Campazzo,PG,30,DEN,65,4,1184,107,296,0.361,58,193,0.301,49,103,0.476,0.459,60,78,0.769,23,94,117,220,63,23,67,124,332
Vlatko Čančar,PF,24,DEN,15,1,176,23,41,0.561,7,12,0.583,16,29,0.552,0.646,9,14,0.643,8,23,31,17,2,3,9,18,62
Devin Cannady,PG,25,ORL,5,0,145,15,44,0.341,15,37,0.405,0,7,0,0.511,5,7,0.714,1,5,6,10,5,3,5,9,50
Clint Capela,C,27,ATL,74,73,2042,370,604,0.613,0,1,0,370,603,0.614,0.613,80,169,0.473,279,598,877,92,55,93,44,166,820
Vernon Carey Jr.,C,20,TOT,7,1,44,7,13,0.538,0,0,0,7,13,0.538,0.538,6,13,0.462,8,4,12,0,2,1,3,4,20
Jevon Carter,PG,26,TOT,66,3,905,98,253,0.387,66,170,0.388,32,83,0.386,0.518,15,18,0.833,14,96,110,96,24,14,34,67,277
Wendell Carter Jr.,PF,22,ORL,62,61,1852,359,684,0.525,70,214,0.327,289,470,0.615,0.576,143,207,0.691,139,509,648,171,36,43,117,169,931
Alex Caruso,SG,27,CHI,41,18,1147,102,256,0.398,42,126,0.333,60,130,0.462,0.48,58,73,0.795,33,115,148,165,71,15,57,106,304
Willie Cauley-Stein,C,28,TOT,20,2,183,16,35,0.457,1,2,0.5,15,33,0.455,0.471,1,2,0.5,13,27,40,10,6,3,7,19,34
Ahmad Caver,SG,25,IND,1,0,1,1,1,1,0,0,0,1,1,1,1,0,0,0,0,0,0,0,0,0,0,0,2
Justin Champagnie,SF,20,TOR,36,0,281,31,67,0.463,10,28,0.357,21,39,0.538,0.537,9,9,1,37,35,72,11,8,4,8,32,81
Zylan Cheatham,SF,26,UTA,1,0,5,0,3,0,0,2,0,0,1,0,0,0,0,0,0,0,0,0,0,0,0,0,0
Chris Chiozza,PG,26,GSW,34,1,372,24,81,0.296,17,53,0.321,7,28,0.25,0.401,2,3,0.667,9,27,36,65,13,0,32,32,67
Marquese Chriss,PF,24,DAL,34,0,346,62,134,0.463,8,25,0.32,54,109,0.495,0.493,22,33,0.667,33,70,103,17,13,12,17,64,154
Josh Christopher,SG,20,HOU,74,2,1334,224,500,0.448,56,189,0.296,168,311,0.54,0.504,83,113,0.735,52,134,186,150,65,13,114,97,587
Gary Clark,PF,27,NOP,38,1,378,33,88,0.375,28,70,0.4,5,18,0.278,0.534,7,10,0.7,23,67,90,18,13,7,10,20,101
Brandon Clarke,PF,25,MEM,64,1,1246,288,447,0.644,5,22,0.227,283,425,0.666,0.65,85,130,0.654,135,207,342,86,39,68,34,122,666
Jordan Clarkson,SG,29,UTA,79,1,2141,466,1113,0.419,190,597,0.318,276,516,0.535,0.504,144,174,0.828,67,206,273,194,66,16,129,149,1266
Nic Claxton,C,22,BRK,47,19,974,178,264,0.674,0,0,0,178,264,0.674,0.674,54,93,0.581,91,173,264,43,24,51,38,110,410
Amir Coffey,SG,24,LAC,69,30,1567,211,466,0.453,96,254,0.378,115,212,0.542,0.556,101,117,0.863,26,171,197,124,38,15,45,87,619
John Collins,PF,24,ATL,54,53,1663,339,644,0.526,64,176,0.364,275,468,0.588,0.576,134,169,0.793,93,329,422,98,33,56,60,164,876
Zach Collins,C,24,SAS,28,4,502,76,155,0.49,14,41,0.341,62,114,0.544,0.535,52,65,0.8,46,107,153,61,13,23,45,67,218
Darren Collison,PG,34,LAL,3,0,37,2,7,0.286,0,3,0,2,4,0.5,0.286,0,0,0,0,4,4,2,1,0,1,5,4
Mike Conley,PG,34,UTA,72,72,2058,344,791,0.435,169,414,0.408,175,377,0.464,0.542,129,162,0.796,47,170,217,385,96,21,123,142,986
Pat Connaughton,SF,29,MIL,65,19,1691,227,496,0.458,146,370,0.395,81,126,0.643,0.605,45,54,0.833,45,228,273,82,59,15,35,86,645
Tyler Cook,PF,24,CHI,20,2,200,23,38,0.605,0,0,0,23,38,0.605,0.605,21,32,0.656,16,37,53,3,4,4,7,28,67
Sharife Cooper,PG,20,ATL,13,0,39,3,14,0.214,1,6,0.167,2,8,0.25,0.25,0,0,0,0,5,5,5,0,0,5,1,7
Petr Cornelie,PF,26,DEN,13,0,38,5,15,0.333,1,8,0.125,4,7,0.571,0.367,3,4,0.75,7,7,14,3,1,1,4,7,14
DeMarcus Cousins,C,31,TOT,48,7,718,149,324,0.46,37,122,0.303,112,202,0.554,0.517,95,125,0.76,74,196,270,71,35,21,85,139,430
Robert Covington,PF,31,TOT,71,42,1940,209,498,0.42,128,339,0.378,81,159,0.509,0.548,58,69,0.841,59,332,391,92,103,91,75,190,604
Torrey Craig,SF,31,TOT,78,16,1596,200,441,0.454,77,234,0.329,123,207,0.594,0.541,39,52,0.75,86,224,310,91,46,36,67,151,516
Jae Crowder,PF,31,PHO,67,67,1886,217,544,0.399,127,365,0.348,90,179,0.503,0.516,71,90,0.789,30,324,354,124,95,30,55,173,632
Jarrett Culver,SG,22,MEM,37,0,338,51,135,0.378,12,47,0.255,39,88,0.443,0.422,16,34,0.471,13,35,48,33,20,5,20,42,130
Jarron Cumberland,SG,24,POR,3,0,12,1,2,0.5,0,1,0,1,1,1,0.5,0,0,0,1,2,3,1,0,0,0,2,2
Cade Cunningham,SG,20,DET,64,64,2088,429,1031,0.416,114,363,0.314,315,668,0.472,0.471,142,168,0.845,58,296,354,356,78,43,234,200,1114
Seth Curry,SG,31,TOT,64,64,2135,360,739,0.487,158,374,0.422,202,365,0.553,0.594,82,94,0.872,21,179,200,230,53,14,109,148,960
Stephen Curry,PG,33,GSW,64,64,2211,535,1224,0.437,285,750,0.38,250,474,0.527,0.554,275,298,0.923,34,301,335,404,85,23,206,130,1630
Anthony Davis,C,28,LAL,40,40,1404,370,695,0.532,13,70,0.186,357,625,0.571,0.542,174,244,0.713,106,288,394,122,49,90,82,97,927
Ed Davis,C,32,CLE,31,3,201,11,16,0.688,0,0,0,11,16,0.688,0.688,6,14,0.429,14,50,64,7,3,9,5,33,28
Terence Davis,SG,24,SAC,30,11,536,113,267,0.423,49,149,0.329,64,118,0.542,0.515,36,44,0.818,11,83,94,40,25,11,33,70,311
Gabriel Deck,PF,26,OKC,7,0,56,8,14,0.571,2,4,0.5,6,10,0.6,0.643,0,0,0,1,5,6,5,1,0,2,2,18
Dewayne Dedmon,C,32,MIA,67,15,1065,164,290,0.566,19,47,0.404,145,243,0.597,0.598,75,100,0.75,105,281,386,47,24,42,70,174,422
Sam Dekker,PF,27,TOR,1,0,1,0,0,0,0,0,0,0,0,0,0,0,0,0,0,0,0,0,0,0,0,0,0
Javin DeLaurier,C,23,MIL,1,0,3,0,0,0,0,0,0,0,0,0,0,0,0,0,0,1,1,0,1,0,0,1,0
DeMar DeRozan,PF,32,CHI,76,76,2743,774,1535,0.504,50,142,0.352,724,1393,0.52,0.521,520,593,0.877,56,336,392,374,68,24,181,178,2118
Mamadi Diakite,PF,25,OKC,13,3,188,25,47,0.532,0,5,0,25,42,0.595,0.532,6,11,0.545,17,42,59,2,5,9,7,33,56
Cheick Diallo,C,25,DET,3,0,31,3,8,0.375,0,0,0,3,8,0.375,0.375,5,6,0.833,4,8,12,0,1,0,1,6,11
Hamidou Diallo,SG,23,DET,58,29,1269,261,526,0.496,23,93,0.247,238,433,0.55,0.518,91,140,0.65,69,208,277,73,71,17,58,143,636
Gorgui Dieng,C,32,ATL,44,3,371,53,112,0.473,29,68,0.426,24,44,0.545,0.603,19,26,0.731,32,89,121,34,11,13,20,52,154
Spencer Dinwiddie,PG-SG,28,TOT,67,51,1980,306,735,0.416,112,330,0.339,194,405,0.479,0.493,195,252,0.774,45,234,279,346,44,13,104,150,919
Donte DiVincenzo,SG,25,TOT,42,1,1006,118,336,0.351,74,218,0.339,44,118,0.373,0.461,70,83,0.843,40,130,170,118,48,8,72,69,380
Luka Dončić,PG,22,DAL,65,65,2301,641,1403,0.457,201,569,0.353,440,834,0.528,0.529,364,489,0.744,56,537,593,568,75,36,292,145,1847
Luguentz Dort,SG,22,OKC,51,51,1665,293,726,0.404,130,391,0.332,163,335,0.487,0.493,161,191,0.843,38,174,212,88,46,18,88,149,877
Ayo Dosunmu,SG,22,CHI,77,40,2110,278,535,0.52,70,186,0.376,208,349,0.596,0.585,53,78,0.679,27,187,214,256,60,29,108,182,679
Damyean Dotson,SG,27,NYK,2,0,21,2,4,0.5,0,1,0,2,3,0.667,0.5,0,0,0,0,2,2,1,0,0,0,0,4
Devon Dotson,PG,22,CHI,11,0,85,11,23,0.478,2,9,0.222,9,14,0.643,0.522,5,9,0.556,1,8,9,15,1,0,5,11,29
Sekou Doumbouya,PF,21,LAL,2,0,16,5,8,0.625,1,2,0.5,4,6,0.667,0.688,3,4,0.75,2,4,6,0,3,2,2,1,14
Jeff Dowtin,PG,24,TOT,9,0,108,8,26,0.308,1,9,0.111,7,17,0.412,0.327,2,2,1,8,10,18,10,5,1,5,5,19
PJ Dozier,SG,25,DEN,18,0,340,36,99,0.364,15,48,0.313,21,51,0.412,0.439,10,13,0.769,14,49,63,29,11,6,13,33,97
Goran Dragić,PG,35,TOT,21,8,498,57,151,0.377,16,63,0.254,41,88,0.466,0.43,27,33,0.818,13,52,65,86,19,4,34,45,157
Andre Drummond,C,28,TOT,73,36,1437,247,433,0.57,0,3,0,247,430,0.574,0.57,86,164,0.524,229,451,680,131,78,68,115,192,580
Chris Duarte,SG,24,IND,55,39,1541,268,621,0.432,94,255,0.369,174,366,0.475,0.507,90,112,0.804,41,185,226,114,56,10,90,95,720
David Duke Jr.,PG,22,BRK,22,7,341,39,108,0.361,9,37,0.243,30,71,0.423,0.403,17,21,0.81,30,37,67,17,14,7,9,36,104
Kris Dunn,PG,27,POR,14,3,336,44,102,0.431,1,11,0.091,43,91,0.473,0.436,17,18,0.944,9,40,49,79,23,3,32,38,106
Kevin Durant,PF,33,BRK,55,55,2047,578,1115,0.518,115,300,0.383,463,815,0.568,0.57,372,409,0.91,29,378,407,351,48,52,191,113,1643
Jaime Echenique,C,24,WAS,1,0,3,0,0,0,0,0,0,0,0,0,0,0,0,0,0,0,0,0,0,0,0,0,0
Anthony Edwards,SG,20,MIN,72,72,2466,549,1245,0.441,215,602,0.357,334,643,0.519,0.527,220,280,0.786,62,281,343,275,105,46,190,164,1533
Carsen Edwards,SG,23,DET,4,0,79,9,30,0.3,4,16,0.25,5,14,0.357,0.367,1,1,1,2,4,6,14,2,0,5,4,23
Kessler Edwards,SF,21,BRK,48,23,987,110,267,0.412,48,136,0.353,62,131,0.473,0.502,16,19,0.842,44,128,172,31,29,24,42,85,284
Rob Edwards,SG,25,OKC,2,0,11,1,4,0.25,1,4,0.25,0,0,0,0.375,0,0,0,0,3,3,0,0,0,1,0,3
CJ Elleby,SF,21,POR,58,28,1174,121,308,0.393,37,126,0.294,84,182,0.462,0.453,60,84,0.714,66,161,227,87,35,19,56,116,339
Wayne Ellington,SG,34,LAL,43,9,810,98,237,0.414,82,211,0.389,16,26,0.615,0.586,9,11,0.818,10,67,77,30,23,5,19,42,287
Joel Embiid,C,27,PHI,68,68,2297,666,1334,0.499,93,251,0.371,573,1083,0.529,0.534,654,803,0.814,146,650,796,284,77,99,214,181,2079
James Ennis III,SF,31,TOT,7,0,56,11,24,0.458,3,8,0.375,8,16,0.5,0.521,4,5,0.8,5,7,12,3,2,2,2,5,29
Drew Eubanks,C,24,TOT,71,31,1245,221,371,0.596,5,23,0.217,216,348,0.621,0.602,99,130,0.762,130,252,382,85,31,40,81,122,546
Tacko Fall,C,26,CLE,11,1,59,5,12,0.417,0,0,0,5,12,0.417,0.417,2,7,0.286,7,16,23,2,0,6,3,3,12
Derrick Favors,C,30,OKC,39,18,653,94,182,0.516,2,16,0.125,92,166,0.554,0.522,16,25,0.64,58,126,184,25,17,12,9,62,206
Bruno Fernando,C,23,TOT,30,0,152,36,55,0.655,1,2,0.5,35,53,0.66,0.664,15,24,0.625,18,37,55,7,1,11,14,24,88
Dorian Finney-Smith,PF,28,DAL,80,80,2644,326,692,0.471,172,435,0.395,154,257,0.599,0.595,56,83,0.675,122,253,375,150,88,39,80,183,880
Malik Fitts,PF,24,TOT,15,0,63,8,19,0.421,5,10,0.5,3,9,0.333,0.553,0,0,0,2,15,17,5,0,0,2,4,21
Malachi Flynn,PG,23,TOR,44,5,537,72,183,0.393,30,90,0.333,42,93,0.452,0.475,15,24,0.625,10,53,63,70,20,4,13,45,189
Bryn Forbes,SG,28,TOT,75,2,1286,231,539,0.429,122,295,0.414,109,244,0.447,0.542,79,87,0.908,10,83,93,75,25,5,56,95,663
Aleem Ford,SF,24,ORL,5,0,74,6,20,0.3,2,15,0.133,4,5,0.8,0.35,0,0,0,2,13,15,2,1,0,4,7,14
Trent Forrest,PG,23,UTA,60,6,765,76,155,0.49,5,27,0.185,71,128,0.555,0.506,38,48,0.792,23,76,99,106,30,6,48,43,195
Evan Fournier,SG,29,NYK,80,80,2358,402,965,0.417,241,619,0.389,161,346,0.465,0.541,80,113,0.708,34,176,210,171,79,20,105,180,1125
De'Aaron Fox,PG,24,SAC,59,59,2083,516,1092,0.473,74,249,0.297,442,843,0.524,0.506,261,348,0.75,25,206,231,330,68,25,168,172,1367
Melvin Frazier,SG,25,OKC,3,0,120,13,48,0.271,1,21,0.048,12,27,0.444,0.281,5,7,0.714,5,8,13,1,1,0,3,8,32
Tim Frazier,PG,31,TOT,12,3,208,14,45,0.311,6,17,0.353,8,28,0.286,0.378,5,9,0.556,5,14,19,34,3,1,15,27,39
Enes Freedom,C,29,BOS,35,1,411,51,97,0.526,2,5,0.4,49,92,0.533,0.536,24,28,0.857,61,99,160,8,5,14,20,42,128
Markelle Fultz,PG,23,ORL,18,3,360,83,175,0.474,4,17,0.235,79,158,0.5,0.486,25,31,0.806,4,45,49,99,20,5,40,22,195
Wenyen Gabriel,PF,24,TOT,26,5,358,54,110,0.491,8,28,0.286,46,82,0.561,0.527,25,42,0.595,39,58,97,14,5,11,16,68,141
Daniel Gafford,C,23,WAS,72,53,1444,285,411,0.693,0,1,0,285,410,0.695,0.693,107,153,0.699,155,252,407,68,30,99,65,170,677
Danilo Gallinari,PF,33,ATL,66,18,1672,259,597,0.434,112,294,0.381,147,303,0.485,0.528,141,156,0.904,35,273,308,101,28,12,38,93,771
Langston Galloway,SG,30,TOT,7,0,107,6,26,0.231,2,16,0.125,4,10,0.4,0.269,0,0,0,3,15,18,12,1,0,6,7,14
Darius Garland,PG,22,CLE,68,68,2430,542,1173,0.462,174,454,0.383,368,719,0.512,0.536,215,241,0.892,39,185,224,583,89,7,248,115,1473
Marcus Garrett,SG,23,MIA,12,0,128,5,21,0.238,1,4,0.25,4,17,0.235,0.262,2,5,0.4,9,14,23,7,5,3,2,16,13
Usman Garuba,PF,19,HOU,24,2,239,19,44,0.432,5,20,0.25,14,24,0.583,0.489,5,7,0.714,21,62,83,17,10,11,6,28,48
Luka Garza,C,23,DET,32,5,389,66,147,0.449,16,49,0.327,50,98,0.51,0.503,38,61,0.623,58,42,100,20,9,6,18,55,186
Rudy Gay,PF,35,UTA,55,1,1038,157,379,0.414,70,203,0.345,87,176,0.494,0.507,62,79,0.785,55,187,242,56,25,19,47,95,446
Paul George,PF,31,LAC,31,31,1077,268,636,0.421,91,257,0.354,177,379,0.467,0.493,127,148,0.858,12,201,213,176,67,13,126,74,754
Taj Gibson,C,36,NYK,52,4,946,86,166,0.518,15,38,0.395,71,128,0.555,0.563,42,52,0.808,88,141,229,32,22,40,27,137,229
Josh Giddey,SF,19,OKC,54,54,1700,281,670,0.419,56,213,0.263,225,457,0.492,0.461,56,79,0.709,98,323,421,345,51,20,171,88,674
Shai Gilgeous-Alexander,PG,23,OKC,56,56,1942,477,1052,0.453,89,297,0.3,388,755,0.514,0.496,328,405,0.81,37,241,278,331,71,46,154,142,1371
Anthony Gill,PF,29,WAS,44,0,463,62,109,0.569,14,26,0.538,48,83,0.578,0.633,42,52,0.808,33,52,85,27,5,11,18,58,180
Freddie Gillespie,PF,24,ORL,9,2,119,9,22,0.409,0,1,0,9,21,0.429,0.409,3,7,0.429,13,23,36,5,3,9,5,18,21
Rudy Gobert,C,29,UTA,66,66,2120,362,508,0.713,0,4,0,362,504,0.718,0.713,303,439,0.69,241,727,968,72,45,137,119,176,1027
Brandon Goodwin,PG,26,CLE,36,5,502,64,154,0.416,19,55,0.345,45,99,0.455,0.477,24,38,0.632,14,53,67,91,25,1,36,39,171
Jordan Goodwin,SG,23,WAS,2,0,6,0,3,0,0,1,0,0,2,0,0,0,0,0,0,1,1,0,0,0,0,1,0
Aaron Gordon,PF,26,DEN,75,75,2376,434,834,0.52,87,260,0.335,347,574,0.605,0.573,171,230,0.743,125,314,439,188,44,44,133,148,1126
Eric Gordon,SG,33,HOU,57,46,1669,268,564,0.475,124,301,0.412,144,263,0.548,0.585,105,135,0.778,15,98,113,154,28,18,107,63,765
Devonte' Graham,PG,26,NOP,76,63,2162,296,815,0.363,192,563,0.341,104,252,0.413,0.481,118,140,0.843,37,140,177,316,71,12,105,95,902
Jerami Grant,PF,27,DET,47,47,1500,298,699,0.426,91,254,0.358,207,445,0.465,0.491,217,259,0.838,28,163,191,111,44,49,85,107,904
Hassani Gravett,PG,25,ORL,8,3,171,18,38,0.474,11,26,0.423,7,12,0.583,0.618,3,4,0.75,1,20,21,20,5,1,9,13,50
Danny Green,SF,34,PHI,62,28,1353,126,320,0.394,103,271,0.38,23,49,0.469,0.555,11,14,0.786,32,125,157,64,60,37,45,105,366
Draymond Green,PF,31,GSW,46,44,1329,135,257,0.525,16,54,0.296,119,203,0.586,0.556,60,91,0.659,45,291,336,320,61,50,139,136,346
Jalen Green,SG,19,HOU,67,67,2138,406,954,0.426,157,458,0.343,249,496,0.502,0.508,188,236,0.797,33,193,226,176,44,18,135,103,1157
JaMychal Green,PF,31,DEN,67,8,1085,159,327,0.486,33,124,0.266,126,203,0.621,0.537,81,93,0.871,81,200,281,59,43,26,57,158,432
Javonte Green,SF,28,CHI,65,45,1519,176,325,0.542,36,101,0.356,140,224,0.625,0.597,80,96,0.833,91,185,276,60,67,32,30,132,468
Jeff Green,PF,35,DEN,75,63,1849,277,529,0.524,53,168,0.315,224,361,0.62,0.574,165,198,0.833,41,190,231,96,28,27,71,151,772
Josh Green,SG,21,DAL,67,3,1039,130,256,0.508,28,78,0.359,102,178,0.573,0.563,31,45,0.689,52,109,161,79,45,14,44,115,319
Blake Griffin,C,32,BRK,56,24,958,133,313,0.425,38,145,0.262,95,168,0.565,0.486,55,76,0.724,60,168,228,105,27,14,31,95,359
Quentin Grimes,SG,21,NYK,46,6,786,95,235,0.404,72,189,0.381,23,46,0.5,0.557,13,19,0.684,24,70,94,44,31,11,28,72,275
Kyle Guy,SG,24,MIA,19,0,186,26,65,0.4,14,40,0.35,12,25,0.48,0.508,8,12,0.667,4,13,17,17,7,1,13,12,74
Rui Hachimura,PF,23,WAS,42,13,943,187,381,0.491,55,123,0.447,132,258,0.512,0.563,46,66,0.697,25,135,160,48,23,9,33,53,475
Tyrese Haliburton,SG-PG,21,TOT,77,77,2695,430,909,0.473,161,389,0.414,269,520,0.517,0.562,160,190,0.842,61,250,311,628,134,49,199,121,1181
Tyler Hall,SG,24,NYK,1,0,2,0,0,0,0,0,0,0,0,0,0,0,0,0,0,0,0,0,0,0,0,0,0
R.J. Hampton,SG,20,ORL,64,14,1402,175,457,0.383,64,183,0.35,111,274,0.405,0.453,75,117,0.641,23,171,194,158,42,13,87,101,489
Tim Hardaway Jr.,SG,29,DAL,42,20,1245,209,530,0.394,102,304,0.336,107,226,0.473,0.491,78,103,0.757,13,143,156,92,38,6,34,74,598
James Harden,PG,32,TOT,65,65,2419,407,992,0.41,148,448,0.33,259,544,0.476,0.485,470,536,0.877,55,445,500,667,82,36,284,153,1432
Maurice Harkless,SF,28,SAC,47,24,863,83,181,0.459,31,101,0.307,52,80,0.65,0.544,20,28,0.714,12,100,112,23,29,24,31,77,217
Jared Harper,PG,24,NOP,5,0,43,14,26,0.538,5,12,0.417,9,14,0.643,0.635,4,4,1,2,0,2,14,4,1,2,5,37
Montrezl Harrell,C,28,TOT,71,3,1641,358,555,0.645,4,17,0.235,354,538,0.658,0.649,212,296,0.716,149,282,431,145,29,43,72,137,932
Gary Harris,SG,27,ORL,61,30,1730,240,553,0.434,116,302,0.384,124,251,0.494,0.539,83,95,0.874,36,86,122,108,59,9,61,112,679
Joe Harris,SF,30,BRK,14,14,423,56,124,0.452,41,88,0.466,15,36,0.417,0.617,5,6,0.833,5,51,56,14,7,2,16,31,158
Tobias Harris,PF,29,PHI,73,73,2543,493,1022,0.482,101,275,0.367,392,747,0.525,0.532,170,202,0.842,77,419,496,252,47,43,116,164,1257
Shaquille Harrison,SG,28,BRK,2,0,23,2,6,0.333,0,2,0,2,4,0.5,0.333,0,0,0,1,3,4,3,1,1,2,3,4
Josh Hart,SG,26,TOT,54,53,1791,287,569,0.504,73,213,0.343,214,356,0.601,0.569,160,211,0.758,62,326,388,224,61,13,114,150,807
Isaiah Hartenstein,C,23,LAC,68,0,1216,229,366,0.626,14,30,0.467,215,336,0.64,0.645,91,132,0.689,117,215,332,160,50,77,84,167,563
Udonis Haslem,C,41,MIA,13,0,83,14,31,0.452,1,4,0.25,13,27,0.481,0.468,3,3,1,4,21,25,4,1,1,5,15,32
Sam Hauser,SF,24,BOS,26,0,158,23,50,0.46,19,44,0.432,4,6,0.667,0.65,0,0,0,5,24,29,10,1,2,2,7,65
Jaxson Hayes,C,21,NOP,70,28,1398,245,398,0.616,20,57,0.351,225,341,0.66,0.641,144,188,0.766,115,200,315,43,33,55,54,155,654
Killian Hayes,PG,20,DET,66,40,1647,176,459,0.383,44,167,0.263,132,292,0.452,0.431,57,74,0.77,36,174,210,277,78,35,111,183,453
Gordon Hayward,SF,31,CHO,49,48,1564,283,617,0.459,86,220,0.391,197,397,0.496,0.528,126,149,0.846,38,186,224,177,47,22,81,85,778
Aaron Henry,SF,22,PHI,6,0,17,1,5,0.2,0,1,0,1,4,0.25,0.2,0,0,0,0,1,1,0,0,2,2,2,2
Juancho Hernangómez,PF,26,TOT,40,9,445,44,106,0.415,24,69,0.348,20,37,0.541,0.528,19,34,0.559,28,72,100,20,14,10,16,25,131
Willy Hernangómez,C,27,NOP,50,8,839,170,327,0.52,4,12,0.333,166,315,0.527,0.526,109,141,0.773,143,195,338,63,21,19,51,97,453
Tyler Herro,SG,22,MIA,66,10,2151,501,1122,0.447,175,439,0.399,326,683,0.477,0.525,190,219,0.868,32,297,329,263,44,8,174,95,1367
Buddy Hield,SG,29,TOT,81,32,2499,446,1098,0.406,262,716,0.366,184,382,0.482,0.526,111,127,0.874,66,287,353,229,73,25,153,184,1265
Haywood Highsmith,SF,25,MIA,19,1,163,16,46,0.348,9,28,0.321,7,18,0.389,0.446,2,5,0.4,10,16,26,6,2,3,3,13,43
George Hill,PG,35,MIL,54,17,1253,118,275,0.429,41,134,0.306,77,141,0.546,0.504,57,62,0.919,38,117,155,120,42,6,41,70,334
Malcolm Hill,SF-SG,26,TOT,19,0,212,24,52,0.462,13,36,0.361,11,16,0.688,0.587,11,14,0.786,11,24,35,8,7,3,3,24,72
Solomon Hill,SF,30,ATL,13,1,139,3,20,0.15,2,13,0.154,1,7,0.143,0.2,0,0,0,6,17,23,12,4,2,1,16,8
Nate Hinton,SG,22,IND,2,0,2,0,1,0,0,0,0,0,1,0,0,0,0,0,0,0,0,0,0,0,1,0,0
Jaylen Hoard,SF,22,OKC,7,5,240,44,90,0.489,9,25,0.36,35,65,0.538,0.539,6,14,0.429,30,54,84,17,6,5,8,14,103
Aaron Holiday,PG,25,TOT,63,15,1021,151,338,0.447,39,103,0.379,112,235,0.477,0.504,59,68,0.868,24,98,122,153,42,9,67,92,400
Jrue Holiday,PG,31,MIL,67,64,2207,478,954,0.501,132,321,0.411,346,633,0.547,0.57,137,180,0.761,69,232,301,457,108,29,183,133,1225
Justin Holiday,SF-SG,32,TOT,74,65,2057,261,662,0.394,177,482,0.367,84,180,0.467,0.528,50,62,0.806,29,161,190,128,57,33,70,154,749
Richaun Holmes,C,28,SAC,45,37,1074,198,300,0.66,2,5,0.4,196,295,0.664,0.663,70,90,0.778,93,224,317,48,17,41,56,128,468
Rodney Hood,PF-SF,29,TOT,52,0,709,58,157,0.369,30,91,0.33,28,66,0.424,0.465,17,19,0.895,15,62,77,38,15,6,11,31,163
Scotty Hopson,SG,32,OKC,1,0,18,2,4,0.5,0,1,0,2,3,0.667,0.5,0,0,0,0,1,1,1,0,0,2,1,4
Al Horford,C,35,BOS,69,69,2005,266,569,0.467,89,265,0.336,177,304,0.582,0.546,80,95,0.842,108,422,530,232,49,92,65,130,701
Talen Horton-Tucker,SG,21,LAL,60,19,1511,224,538,0.416,49,182,0.269,175,356,0.492,0.462,100,125,0.8,37,156,193,159,59,29,82,148,597
Danuel House Jr.,SF,28,TOT,42,7,727,80,198,0.404,44,117,0.376,36,81,0.444,0.515,44,58,0.759,18,93,111,44,21,17,33,51,248
Dwight Howard,C,36,LAL,60,27,971,134,219,0.612,8,15,0.533,126,204,0.618,0.63,96,146,0.658,118,238,356,35,34,36,47,115,372
Markus Howard,SG,22,DEN,31,0,176,39,101,0.386,28,70,0.4,11,31,0.355,0.525,20,23,0.87,2,10,12,7,9,0,7,17,126
Kevin Huerter,SF,23,ATL,74,60,2188,345,760,0.454,160,411,0.389,185,349,0.53,0.559,42,52,0.808,32,222,254,203,55,26,91,185,892
Jay Huff,C,23,LAL,4,0,20,0,3,0,0,2,0,0,1,0,0,0,0,0,1,3,4,1,1,1,1,1,0
Elijah Hughes,SG-SF,23,TOT,36,4,434,47,144,0.326,25,95,0.263,22,49,0.449,0.413,7,9,0.778,6,52,58,22,14,8,17,39,126
Feron Hunt,SF,22,NYK,2,0,8,0,2,0,0,0,0,0,2,0,0,0,0,0,1,0,1,1,1,0,1,1,0
De'Andre Hunter,SF,24,ATL,53,52,1577,254,575,0.442,74,195,0.379,180,380,0.474,0.506,127,166,0.765,26,150,176,68,36,21,69,155,709
Chandler Hutchison,SF,25,PHO,6,0,22,1,2,0.5,0,0,0,1,2,0.5,0.5,2,2,1,0,5,5,2,0,0,4,1,4
Bones Hyland,SG,21,DEN,69,4,1310,230,571,0.403,131,358,0.366,99,213,0.465,0.518,107,125,0.856,14,174,188,191,41,20,86,153,698
Serge Ibaka,C,32,TOT,54,12,877,148,296,0.5,37,99,0.374,111,197,0.563,0.563,32,44,0.727,62,188,250,49,11,33,43,102,365
Andre Iguodala,SF,38,GSW,31,0,603,46,121,0.38,17,74,0.23,29,47,0.617,0.45,15,20,0.75,21,79,100,114,27,22,28,34,124
Joe Ingles,SF,34,UTA,45,15,1122,115,285,0.404,78,225,0.347,37,60,0.617,0.54,17,22,0.773,12,119,131,158,23,5,46,82,325
Brandon Ingram,SF,24,NOP,55,55,1869,453,983,0.461,74,226,0.327,379,757,0.501,0.498,266,322,0.826,35,285,320,307,34,26,151,119,1246
Kyrie Irving,PG,29,BRK,29,29,1091,289,616,0.469,100,239,0.418,189,377,0.501,0.55,118,129,0.915,16,111,127,167,41,17,73,81,796
Wes Iwundu,SF,27,ATL,3,1,82,8,18,0.444,3,5,0.6,5,13,0.385,0.528,3,4,0.75,3,10,13,0,1,0,1,8,22
Frank Jackson,PG,23,DET,53,7,1164,194,483,0.402,86,279,0.308,108,204,0.529,0.491,86,104,0.827,19,68,87,55,27,9,38,89,560
Isaiah Jackson,PF,20,IND,36,15,541,116,206,0.563,5,16,0.313,111,190,0.584,0.575,60,88,0.682,60,89,149,10,25,52,40,92,297
Jaren Jackson Jr.,PF,22,MEM,78,78,2126,430,1036,0.415,128,401,0.319,302,635,0.476,0.477,284,345,0.823,119,335,454,86,73,177,130,272,1272
Josh Jackson,SF,24,TOT,51,3,830,120,300,0.4,33,130,0.254,87,170,0.512,0.455,55,77,0.714,21,120,141,54,26,22,47,88,328
Justin Jackson,SF,26,TOT,7,0,37,5,15,0.333,3,9,0.333,2,6,0.333,0.433,2,2,1,1,6,7,2,0,0,1,3,15
Reggie Jackson,SG,31,LAC,75,75,2337,479,1222,0.392,167,512,0.326,312,710,0.439,0.46,138,163,0.847,39,232,271,359,55,15,173,159,1263
LeBron James,PF,37,LAL,56,56,2084,640,1221,0.524,161,448,0.359,479,773,0.62,0.59,254,336,0.756,63,396,459,349,73,59,196,121,1695
DeJon Jarreau,SG,24,IND,1,0,1,0,0,0,0,0,0,0,0,0,0,0,0,0,0,0,0,0,0,0,0,0,0
DaQuan Jeffries,SG,24,MEM,3,0,9,1,2,0.5,0,1,0,1,1,1,0.5,0,0,0,0,2,2,1,0,0,0,1,2
Ty Jerome,SG,24,OKC,48,4,801,124,328,0.378,54,186,0.29,70,142,0.493,0.46,38,47,0.809,19,59,78,109,30,5,37,73,340
Isaiah Joe,SG,22,PHI,55,1,609,62,177,0.35,45,135,0.333,17,42,0.405,0.477,29,31,0.935,6,50,56,35,14,3,19,47,198
Alize Johnson,PF,25,TOT,23,0,167,17,39,0.436,0,4,0,17,35,0.486,0.436,7,12,0.583,28,33,61,9,5,0,12,18,41
B.J. Johnson,SF,26,ORL,4,0,65,11,25,0.44,4,10,0.4,7,15,0.467,0.52,0,0,0,6,9,15,0,0,1,0,4,26
Cameron Johnson,PF,25,PHO,66,16,1730,279,607,0.46,166,391,0.425,113,216,0.523,0.596,98,114,0.86,42,231,273,99,57,16,47,113,822
David Johnson,SG,20,TOR,2,0,2,0,1,0,0,1,0,0,0,0,0,0,0,0,0,0,0,0,0,0,0,0,0
Jalen Johnson,PF,20,ATL,22,0,120,22,41,0.537,3,13,0.231,19,28,0.679,0.573,5,7,0.714,2,24,26,3,3,2,9,9,52
James Johnson,PF,34,BRK,62,10,1191,144,307,0.469,23,85,0.271,121,222,0.545,0.507,29,55,0.527,51,164,215,130,30,34,48,162,340
Joe Johnson,SG,40,BOS,1,0,2,1,1,1,0,0,0,1,1,1,1,0,0,0,0,0,0,0,0,0,0,0,2
Keldon Johnson,SF,22,SAS,75,74,2392,471,1011,0.466,159,399,0.398,312,612,0.51,0.545,177,234,0.756,80,377,457,158,58,14,92,148,1278
Keon Johnson,SG,19,TOT,37,12,697,96,272,0.353,34,100,0.34,62,172,0.36,0.415,41,51,0.804,24,57,81,76,28,12,46,69,267
Stanley Johnson,PF,25,LAL,48,27,1094,117,251,0.466,33,105,0.314,84,146,0.575,0.532,53,74,0.716,34,121,155,80,43,14,35,109,320
Tyler Johnson,PG,29,TOT,6,0,91,6,20,0.3,5,13,0.385,1,7,0.143,0.425,0,0,0,3,9,12,7,3,3,2,7,17
Nikola Jokić,C,26,DEN,74,74,2476,764,1311,0.583,97,288,0.337,667,1023,0.652,0.62,379,468,0.81,206,813,1019,584,109,63,281,191,2004
Carlik Jones,PG,24,TOT,5,0,23,1,9,0.111,0,1,0,1,8,0.125,0.111,2,2,1,1,2,3,5,1,0,3,0,4
Damian Jones,C,26,SAC,56,15,1017,175,266,0.658,10,29,0.345,165,237,0.696,0.677,94,131,0.718,75,171,246,69,26,47,59,130,454
Derrick Jones Jr.,PF,24,CHI,51,8,899,105,195,0.538,20,61,0.328,85,134,0.634,0.59,56,70,0.8,60,109,169,30,25,33,30,105,286
Herbert Jones,PF,23,NOP,78,69,2335,274,576,0.476,57,169,0.337,217,407,0.533,0.525,137,163,0.84,98,198,296,167,130,60,100,238,742
Jemerrio Jones,SF,26,LAL,2,0,15,2,3,0.667,0,0,0,2,3,0.667,0.667,0,0,0,2,1,3,0,1,0,0,2,4
Kai Jones,C,21,CHO,21,0,63,9,14,0.643,1,2,0.5,8,12,0.667,0.679,3,8,0.375,3,8,11,4,1,2,6,8,22
Mason Jones,SG,23,LAL,4,0,51,7,15,0.467,1,4,0.25,6,11,0.545,0.5,12,15,0.8,1,9,10,4,2,0,1,8,27
Tre Jones,PG,22,SAS,69,11,1148,166,339,0.49,10,51,0.196,156,288,0.542,0.504,71,91,0.78,29,126,155,233,42,7,46,78,413
Tyus Jones,PG,25,MEM,73,23,1549,249,552,0.451,80,205,0.39,169,347,0.487,0.524,54,66,0.818,17,159,176,324,66,2,46,32,632
DeAndre Jordan,C,33,TOT,48,20,622,92,143,0.643,0,0,0,92,143,0.643,0.643,22,40,0.55,83,181,264,21,12,35,37,71,206
Cory Joseph,PG,30,DET,65,39,1600,178,400,0.445,65,157,0.414,113,243,0.465,0.526,100,113,0.885,29,145,174,237,42,17,85,147,521
Georgios Kalaitzakis,SF,23,TOT,13,4,214,31,67,0.463,10,26,0.385,21,41,0.512,0.537,14,30,0.467,6,15,21,12,11,2,20,19,86
Frank Kaminsky,C,28,PHO,9,0,181,36,66,0.545,5,15,0.333,31,51,0.608,0.583,18,20,0.9,11,30,41,13,8,7,5,14,95
Luke Kennard,SG,25,LAC,70,13,1919,287,639,0.449,190,423,0.449,97,216,0.449,0.598,69,77,0.896,20,209,229,146,42,6,60,101,833
Braxton Key,SF,24,TOT,11,0,197,33,72,0.458,6,21,0.286,27,51,0.529,0.5,7,13,0.538,13,37,50,11,10,11,11,26,79
George King,SF,28,DAL,4,0,19,0,5,0,0,4,0,0,1,0,0,1,2,0.5,0,5,5,0,0,0,1,4,1
Louis King,SF,22,SAC,10,0,104,15,47,0.319,8,27,0.296,7,20,0.35,0.404,7,10,0.7,0,12,12,9,2,1,0,14,45
Corey Kispert,SF,22,WAS,77,36,1801,234,514,0.455,112,320,0.35,122,194,0.629,0.564,54,62,0.871,53,156,209,85,35,22,50,93,634
Maxi Kleber,PF,30,DAL,59,21,1450,141,354,0.398,83,255,0.325,58,99,0.586,0.516,46,65,0.708,70,280,350,68,30,58,47,137,411
Brandon Knight,PG,30,DAL,5,0,65,10,25,0.4,4,17,0.235,6,8,0.75,0.48,8,8,1,0,8,8,8,1,0,4,5,32
Nathan Knight,PF,24,MIN,37,2,267,45,88,0.511,4,13,0.308,41,75,0.547,0.534,44,60,0.733,32,53,85,22,7,8,18,42,138
Kevin Knox,SF,22,TOT,30,0,222,31,85,0.365,15,54,0.278,16,31,0.516,0.453,16,22,0.727,14,30,44,10,4,2,7,19,93
John Konchar,SG,25,MEM,72,7,1292,135,262,0.515,52,126,0.413,83,136,0.61,0.615,27,49,0.551,87,242,329,109,45,22,29,90,349
Furkan Korkmaz,SG,24,PHI,67,19,1414,182,470,0.387,77,266,0.289,105,204,0.515,0.469,68,84,0.81,22,153,175,127,33,9,48,58,509
Luke Kornet,C,26,TOT,15,0,103,13,27,0.481,0,5,0,13,22,0.591,0.481,4,6,0.667,13,16,29,9,3,3,0,9,30
Vit Krejci,SG,21,OKC,30,8,690,68,167,0.407,32,98,0.327,36,69,0.522,0.503,19,22,0.864,18,83,101,57,19,8,29,65,187
Arnoldas Kulboka,SF,24,CHO,2,0,5,0,1,0,0,1,0,0,0,0,0,0,0,0,0,0,0,0,0,0,0,1,0
Jonathan Kuminga,SF,19,GSW,70,12,1185,236,460,0.513,50,149,0.336,186,311,0.598,0.567,130,190,0.684,54,180,234,64,31,22,74,146,652
Kyle Kuzma,PF,26,WAS,66,66,2204,423,936,0.452,128,375,0.341,295,561,0.526,0.52,156,219,0.712,70,491,561,233,42,57,169,128,1130
Anthony Lamb,SF,24,SAS,2,0,8,0,2,0,0,2,0,0,0,0,0,0,0,0,0,1,1,2,0,0,0,0,0
Jeremy Lamb,SF-SG,29,TOT,56,0,935,133,347,0.383,55,170,0.324,78,177,0.441,0.463,89,106,0.84,26,128,154,81,31,22,37,59,410
Jock Landale,C,26,SAS,54,1,589,101,204,0.495,29,89,0.326,72,115,0.626,0.566,34,41,0.829,63,75,138,45,10,14,31,53,265
Romeo Langford,SG,22,TOT,48,5,771,83,191,0.435,29,85,0.341,54,106,0.509,0.51,23,42,0.548,30,78,108,21,22,16,16,47,218
Zach LaVine,SG,26,CHI,67,67,2328,565,1186,0.476,185,475,0.389,380,711,0.534,0.554,320,375,0.853,22,286,308,303,41,23,171,120,1635
Jake Layman,SF,27,MIN,34,1,231,30,73,0.411,8,35,0.229,22,38,0.579,0.466,13,18,0.722,6,30,36,9,7,5,10,12,81
Damion Lee,SG,29,GSW,63,5,1256,169,383,0.441,63,187,0.337,106,196,0.541,0.523,66,75,0.88,27,176,203,63,39,6,38,95,467
Saben Lee,PG,22,DET,37,0,604,69,177,0.39,14,60,0.233,55,117,0.47,0.429,56,71,0.789,18,69,87,107,36,12,36,44,208
Alex Len,C,28,SAC,39,10,620,94,176,0.534,6,21,0.286,88,155,0.568,0.551,41,63,0.651,52,109,161,45,13,25,43,100,235
Caris LeVert,SG,27,TOT,58,49,1781,379,854,0.444,82,256,0.32,297,598,0.497,0.492,146,193,0.756,43,171,214,248,51,23,108,131,986
Kira Lewis Jr.,PG,20,NOP,24,0,341,59,146,0.404,13,58,0.224,46,88,0.523,0.449,10,12,0.833,9,30,39,49,11,1,26,17,141
Scottie Lewis,SG,21,CHO,2,0,7,0,0,0,0,0,0,0,0,0,0,1,2,0.5,0,0,0,1,1,0,0,0,1
Damian Lillard,PG,31,POR,29,29,1056,222,552,0.402,92,284,0.324,130,268,0.485,0.486,159,181,0.878,13,107,120,212,17,11,83,37,695
Nassir Little,SF,21,POR,42,23,1088,145,315,0.46,51,154,0.331,94,161,0.584,0.541,69,94,0.734,58,178,236,54,25,36,40,82,410
Isaiah Livers,SF,23,DET,19,5,383,41,90,0.456,27,64,0.422,14,26,0.538,0.606,12,14,0.857,15,42,57,21,13,7,15,37,121
Kevon Looney,C,25,GSW,82,80,1732,208,364,0.571,0,1,0,208,363,0.573,0.571,75,125,0.6,208,388,596,165,50,52,67,215,491
Brook Lopez,C,33,MIL,13,11,298,61,131,0.466,19,53,0.358,42,78,0.538,0.538,20,23,0.87,19,34,53,6,8,15,12,34,161
Robin Lopez,C,33,ORL,36,9,612,110,199,0.553,2,6,0.333,108,193,0.56,0.558,32,54,0.593,68,58,126,54,2,18,44,67,254
Didi Louzada,SG-SF,22,TOT,9,1,129,12,33,0.364,9,23,0.391,3,10,0.3,0.5,2,2,1,5,12,17,5,2,2,5,13,35
Kevin Love,C,33,CLE,74,4,1665,327,761,0.43,187,477,0.392,140,284,0.493,0.553,166,198,0.838,87,449,536,160,26,18,98,101,1007
Kyle Lowry,PG,35,MIA,63,63,2133,276,627,0.44,144,382,0.377,132,245,0.539,0.555,148,174,0.851,33,249,282,474,67,17,168,177,844
Gabriel Lundberg,SG,27,PHO,4,0,44,5,19,0.263,3,8,0.375,2,11,0.182,0.342,0,0,0,2,5,7,11,3,0,3,7,13
Timothé Luwawu-Cabarrot,SF,26,ATL,52,18,685,74,186,0.398,44,122,0.361,30,64,0.469,0.516,35,41,0.854,17,65,82,40,18,6,20,76,227
Trey Lyles,PF,26,TOT,75,23,1537,262,562,0.466,67,209,0.321,195,353,0.552,0.526,195,243,0.802,89,290,379,88,29,32,73,123,786
Théo Maledon,PG,20,OKC,51,7,908,119,317,0.375,44,150,0.293,75,167,0.449,0.445,79,100,0.79,20,111,131,111,31,11,65,67,361
Sandro Mamukelashvili,PF,22,MIL,41,3,407,57,115,0.496,22,52,0.423,35,63,0.556,0.591,18,22,0.818,35,47,82,22,9,9,15,28,154
Terance Mann,SF,25,LAC,81,33,2317,334,690,0.484,76,208,0.365,258,482,0.535,0.539,128,164,0.78,104,321,425,209,55,21,84,178,872
Tre Mann,PG,20,OKC,60,26,1367,231,588,0.393,98,272,0.36,133,316,0.421,0.476,65,82,0.793,25,146,171,91,47,12,71,102,625
Boban Marjanović,C,33,DAL,23,0,128,42,70,0.6,1,4,0.25,41,66,0.621,0.607,13,22,0.591,8,31,39,3,0,3,15,24,98
Lauri Markkanen,SF,24,CLE,61,61,1878,313,703,0.445,136,380,0.358,177,323,0.548,0.542,138,159,0.868,59,286,345,81,45,30,54,130,900
Naji Marshall,SF,24,NOP,55,4,735,109,269,0.405,21,105,0.2,88,164,0.537,0.444,74,93,0.796,38,104,142,62,33,8,46,69,313
Caleb Martin,SF,26,MIA,60,12,1372,208,410,0.507,64,155,0.413,144,255,0.565,0.585,71,93,0.763,70,160,230,64,58,30,52,104,551
Cody Martin,SF,26,CHO,71,11,1866,204,423,0.482,61,159,0.384,143,264,0.542,0.554,75,107,0.701,82,203,285,179,88,32,61,116,544
Kelan Martin,SF,26,TOT,30,1,450,70,171,0.409,22,75,0.293,48,96,0.5,0.474,9,13,0.692,17,38,55,21,13,9,14,36,171
Kenyon Martin Jr.,SF,21,HOU,79,2,1656,279,523,0.533,60,168,0.357,219,355,0.617,0.591,78,123,0.634,80,217,297,101,34,40,60,113,696
Garrison Mathews,SG,25,HOU,65,33,1712,184,461,0.399,139,386,0.36,45,75,0.6,0.55,143,180,0.794,32,158,190,64,57,24,41,168,650
Dakota Mathias,SG,26,MEM,6,0,16,2,6,0.333,2,6,0.333,0,0,0,0.5,0,0,0,0,2,2,1,1,0,0,1,6
Wesley Matthews,SG,35,MIL,49,14,1002,87,220,0.395,53,157,0.338,34,63,0.54,0.516,22,28,0.786,30,62,92,36,23,8,18,87,249
Tyrese Maxey,PG,21,PHI,75,74,2650,483,995,0.485,132,309,0.427,351,686,0.512,0.552,213,246,0.866,26,214,240,321,55,32,88,156,1311
Skylar Mays,SG,24,ATL,28,5,220,32,64,0.5,8,25,0.32,24,39,0.615,0.563,8,9,0.889,5,20,25,17,7,0,10,9,80
Miles McBride,PG,21,NYK,40,2,372,32,108,0.296,17,68,0.25,15,40,0.375,0.375,8,12,0.667,4,38,42,41,14,1,5,45,89
Mac McClung,SG-PG,23,TOT,2,0,25,3,6,0.5,1,3,0.333,2,3,0.667,0.583,1,1,1,0,3,3,1,1,1,3,5,8
CJ McCollum,SG,30,TOT,62,62,2145,536,1164,0.46,182,469,0.388,354,695,0.509,0.539,116,170,0.682,53,216,269,315,70,22,127,121,1370
T.J. McConnell,PG,29,IND,27,8,652,100,208,0.481,10,33,0.303,90,175,0.514,0.505,19,23,0.826,20,70,90,131,29,10,29,53,229
Jaden McDaniels,PF,21,MIN,70,31,1803,255,554,0.46,80,252,0.317,175,302,0.579,0.532,57,71,0.803,76,217,293,79,52,54,75,224,647
Jalen McDaniels,SF,24,CHO,55,2,895,123,254,0.484,41,108,0.38,82,146,0.562,0.565,53,72,0.736,37,133,170,58,26,22,36,93,340
Doug McDermott,PF,30,SAS,51,51,1223,215,465,0.462,108,256,0.422,107,209,0.512,0.578,40,51,0.784,18,97,115,64,13,6,43,79,578
JaVale McGee,C,34,PHO,74,17,1172,288,458,0.629,2,9,0.222,286,449,0.637,0.631,102,146,0.699,163,333,496,42,22,81,98,181,680
Cameron McGriff,SF,24,POR,3,0,46,5,14,0.357,2,6,0.333,3,8,0.375,0.429,2,2,1,6,9,15,3,0,1,0,7,14
Rodney McGruder,SG,30,DET,51,2,754,98,225,0.436,58,146,0.397,40,79,0.506,0.564,19,26,0.731,31,80,111,48,21,7,24,58,273
Alfonzo McKinnie,SF,29,CHI,17,3,206,24,61,0.393,9,27,0.333,15,34,0.441,0.467,2,8,0.25,13,20,33,5,2,3,7,26,59
JaQuori McLaughlin,PG,24,DAL,4,0,11,0,2,0,0,1,0,0,1,0,0,0,0,0,0,0,0,2,0,0,0,1,0
Jordan McLaughlin,PG,25,MIN,62,3,902,88,200,0.44,27,85,0.318,61,115,0.53,0.508,30,40,0.75,22,72,94,180,57,10,38,54,233
Ben McLemore,SG,28,POR,64,6,1285,216,539,0.401,151,417,0.362,65,122,0.533,0.541,72,88,0.818,12,91,103,59,38,10,55,103,655
De'Anthony Melton,SG,23,MEM,73,15,1657,281,695,0.404,139,372,0.374,142,323,0.44,0.504,90,120,0.75,64,264,328,194,104,39,112,128,791
Sam Merrill,SG,25,MEM,6,0,58,8,24,0.333,7,23,0.304,1,1,1,0.479,2,4,0.5,1,6,7,4,0,0,2,3,25
Chimezie Metu,C,24,SAC,60,20,1279,203,449,0.452,57,186,0.306,146,263,0.555,0.516,71,91,0.78,34,301,335,60,51,32,61,93,534
Khris Middleton,SF,30,MIL,66,66,2141,452,1021,0.443,162,434,0.373,290,587,0.494,0.522,259,291,0.89,41,315,356,358,76,18,190,160,1325
C.J. Miles,SG,34,BOS,1,0,2,0,0,0,0,0,0,0,0,0,0,0,0,0,0,0,0,0,0,0,0,1,0
Patty Mills,SG,33,BRK,81,48,2346,324,794,0.408,227,568,0.4,97,226,0.429,0.551,48,59,0.814,18,138,156,183,51,17,73,112,923
Paul Millsap,C,36,TOT,33,1,376,45,115,0.391,8,35,0.229,37,80,0.463,0.426,17,24,0.708,41,73,114,29,10,13,19,67,115
Shake Milton,SG,25,PHI,55,6,1179,173,403,0.429,43,133,0.323,130,270,0.481,0.483,61,73,0.836,30,112,142,139,28,17,44,99,450
Davion Mitchell,PG,23,SAC,75,19,2076,352,843,0.418,101,320,0.316,251,523,0.48,0.477,56,85,0.659,33,133,166,313,55,24,114,141,861
Donovan Mitchell,SG,25,UTA,67,67,2266,617,1376,0.448,232,654,0.355,385,722,0.533,0.533,267,313,0.853,55,227,282,358,99,12,200,164,1733
Evan Mobley,PF,20,CLE,69,69,2331,422,830,0.508,23,92,0.25,399,738,0.541,0.522,167,252,0.663,143,427,570,174,56,115,133,147,1034
Malik Monk,SG,23,LAL,76,37,2139,391,826,0.473,173,442,0.391,218,384,0.568,0.578,93,117,0.795,37,219,256,218,61,29,122,138,1048
Greg Monroe,C,31,TOT,14,0,195,32,57,0.561,0,0,0,32,57,0.561,0.561,12,23,0.522,30,34,64,22,8,10,12,24,76
Moses Moody,SG,19,GSW,52,11,607,80,183,0.437,40,110,0.364,40,73,0.548,0.546,28,36,0.778,17,63,80,23,7,10,13,43,228
Xavier Moon,SG,27,LAC,10,0,137,25,51,0.49,5,14,0.357,20,37,0.541,0.539,3,5,0.6,2,12,14,24,7,3,6,9,58
Matt Mooney,SG,24,NYK,1,0,2,0,1,0,0,1,0,0,0,0,0,0,0,0,0,0,0,0,1,0,1,0,0
Ja Morant,PG,22,MEM,57,57,1889,580,1177,0.493,88,256,0.344,492,921,0.534,0.53,316,415,0.761,77,248,325,384,66,22,196,86,1564
Juwan Morgan,PF,24,TOT,2,0,31,2,3,0.667,1,2,0.5,1,1,1,0.833,0,0,0,2,2,4,1,0,0,0,3,5
Jaylen Morris,SG,26,SAS,3,0,16,0,6,0,0,2,0,0,4,0,0,2,4,0.5,0,2,2,2,0,0,1,2,2
Marcus Morris,PF,32,LAC,54,54,1564,300,691,0.434,101,275,0.367,199,416,0.478,0.507,129,148,0.872,26,213,239,113,28,18,69,115,830
Markieff Morris,PF,32,MIA,17,1,298,54,114,0.474,13,39,0.333,41,75,0.547,0.531,8,9,0.889,17,28,45,23,6,1,20,33,129
Monte Morris,PG,26,DEN,75,74,2239,374,773,0.484,124,314,0.395,250,459,0.545,0.564,73,84,0.869,27,199,226,333,56,14,78,92,945
Emmanuel Mudiay,PG,25,SAC,2,0,11,0,2,0,0,0,0,0,2,0,0,3,4,0.75,0,0,0,4,1,0,1,1,3
Mychal Mulder,PG,27,TOT,17,3,239,24,77,0.312,17,54,0.315,7,23,0.304,0.422,4,4,1,2,22,24,5,4,2,8,13,69
Ade Murkey,SG,24,SAC,1,0,1,0,0,0,0,0,0,0,0,0,0,0,0,0,0,0,0,0,0,0,0,0,0
Trey Murphy III,SF,21,NOP,62,1,864,109,277,0.394,71,186,0.382,38,91,0.418,0.522,45,51,0.882,47,100,147,38,23,7,16,60,334
Dejounte Murray,PG,25,SAS,68,68,2366,573,1241,0.462,96,294,0.327,477,947,0.504,0.5,196,247,0.794,80,483,563,627,138,23,180,138,1438
Mike Muscala,C,30,OKC,43,0,592,113,248,0.456,70,163,0.429,43,85,0.506,0.597,48,57,0.842,21,108,129,22,18,26,14,58,344
Svi Mykhailiuk,SF,24,TOR,56,5,716,91,234,0.389,41,134,0.306,50,100,0.5,0.476,32,37,0.865,20,72,92,45,26,4,32,54,255
Abdel Nader,SF,28,PHO,14,0,145,12,35,0.343,4,14,0.286,8,21,0.381,0.4,6,10,0.6,4,23,27,7,8,4,11,20,34
Larry Nance Jr.,C-PF,29,TOT,46,11,1040,129,247,0.522,23,70,0.329,106,177,0.599,0.569,40,57,0.702,72,176,248,81,43,20,37,84,321
RJ Nembhard Jr.,SG,22,CLE,14,0,63,6,18,0.333,0,2,0,6,16,0.375,0.333,3,4,0.75,3,4,7,12,1,0,3,2,15
Aaron Nesmith,SF,22,BOS,52,3,574,72,182,0.396,31,115,0.27,41,67,0.612,0.481,21,26,0.808,15,74,89,22,20,5,31,70,196
Raul Neto,PG,29,WAS,70,19,1372,204,441,0.463,35,120,0.292,169,321,0.526,0.502,83,108,0.769,13,121,134,217,55,3,79,104,526
Malik Newman,PG,24,CLE,1,0,8,3,5,0.6,0,1,0,3,4,0.75,0.6,2,2,1,0,1,1,1,0,0,1,0,8
Georges Niang,PF,28,PHI,76,7,1736,246,563,0.437,156,387,0.403,90,176,0.511,0.575,52,59,0.881,25,178,203,102,30,13,59,190,700
Daishen Nix,SG,19,HOU,24,0,261,27,67,0.403,7,26,0.269,20,41,0.488,0.455,16,30,0.533,7,26,33,40,15,0,26,21,77
Zeke Nnaji,PF,21,DEN,41,1,698,96,186,0.516,37,80,0.463,59,106,0.557,0.616,41,65,0.631,56,91,147,17,16,13,23,79,270
Nerlens Noel,C,27,NYK,25,11,562,32,60,0.533,0,3,0,32,57,0.561,0.533,21,30,0.7,48,93,141,23,30,31,20,67,85
Jaylen Nowell,SG,22,MIN,62,1,975,196,413,0.475,63,160,0.394,133,253,0.526,0.551,72,92,0.783,22,101,123,130,27,10,36,73,527
Frank Ntilikina,SG,23,DAL,58,5,685,89,223,0.399,38,111,0.342,51,112,0.455,0.484,24,25,0.96,12,67,79,69,27,7,31,61,240
Jusuf Nurkić,C,27,POR,56,56,1579,321,600,0.535,15,56,0.268,306,544,0.563,0.548,185,268,0.69,167,452,619,157,62,34,143,189,842
David Nwaba,SF,29,HOU,46,4,609,85,176,0.483,15,49,0.306,70,127,0.551,0.526,48,67,0.716,41,110,151,35,28,20,21,55,233
Jordan Nwora,SF,23,MIL,62,13,1185,186,462,0.403,79,227,0.348,107,235,0.455,0.488,36,43,0.837,37,184,221,59,25,17,57,78,487
Royce O'Neale,SF,28,UTA,77,77,2406,203,444,0.457,119,306,0.389,84,138,0.609,0.591,45,56,0.804,64,304,368,191,86,32,79,183,570
Semi Ojeleye,PF,27,TOT,30,0,406,30,99,0.303,15,50,0.3,15,49,0.306,0.379,23,29,0.793,27,47,74,9,7,6,9,30,98
Chuma Okeke,PF,23,ORL,70,20,1749,216,575,0.376,118,371,0.318,98,204,0.48,0.478,55,65,0.846,47,300,347,118,97,42,57,95,605
Josh Okogie,SG,23,MIN,49,6,516,42,104,0.404,14,47,0.298,28,57,0.491,0.471,35,51,0.686,29,41,70,25,26,12,23,53,133
Onyeka Okongwu,C,21,ATL,48,6,992,156,226,0.69,0,0,0,156,226,0.69,0.69,80,110,0.727,115,168,283,53,31,60,44,149,392
Isaac Okoro,SF,21,CLE,67,61,1981,207,431,0.48,55,157,0.35,152,274,0.555,0.544,119,155,0.768,72,129,201,121,56,22,58,164,588
KZ Okpala,PF,22,MIA,21,0,244,30,69,0.435,9,26,0.346,21,43,0.488,0.5,8,11,0.727,11,30,41,14,4,7,5,25,77
Victor Oladipo,SG,29,MIA,8,1,173,35,73,0.479,15,36,0.417,20,37,0.541,0.582,14,19,0.737,3,20,23,28,5,1,16,13,99
Cameron Oliver,SF,25,ATL,2,0,43,10,15,0.667,1,3,0.333,9,12,0.75,0.7,2,3,0.667,2,4,6,3,1,1,0,5,23
Kelly Olynyk,C,30,DET,40,1,764,128,286,0.448,40,119,0.336,88,167,0.527,0.517,69,89,0.775,54,123,177,111,31,19,58,100,365
Eugene Omoruyi,SF,24,DAL,4,0,18,2,5,0.4,1,2,0.5,1,3,0.333,0.5,2,4,0.5,2,5,7,2,0,0,0,2,7
Miye Oni,SG,24,UTA,16,0,44,2,9,0.222,1,8,0.125,1,1,1,0.278,0,1,0,1,6,7,5,0,0,1,7,5
Cedi Osman,SF,26,CLE,66,3,1462,247,572,0.432,128,359,0.357,119,213,0.559,0.544,87,131,0.664,25,121,146,135,52,10,67,127,709
Daniel Oturu,C,22,TOR,3,0,27,3,6,0.5,0,1,0,3,5,0.6,0.5,3,5,0.6,1,4,5,0,0,2,0,1,9
Kelly Oubre Jr.,SF,26,CHO,76,13,1999,410,932,0.44,191,553,0.345,219,379,0.578,0.542,126,189,0.667,79,223,302,84,77,31,67,189,1137
Jaysean Paige,PG,27,DET,1,0,7,0,3,0,0,2,0,0,1,0,0,0,0,0,0,1,1,1,0,0,1,2,0
Trayvon Palmer,SG,27,DET,1,0,17,0,1,0,0,0,0,0,1,0,0,0,0,0,0,2,2,0,0,0,1,2,0
Kevin Pangos,PG,29,CLE,24,3,166,15,46,0.326,6,26,0.231,9,20,0.45,0.391,3,4,0.75,2,9,11,30,3,0,7,11,39
Jabari Parker,PF,26,BOS,12,0,112,18,38,0.474,8,16,0.5,10,22,0.455,0.579,9,9,1,5,23,28,6,4,1,8,13,53
Eric Paschall,PF,25,UTA,58,3,736,114,235,0.485,40,108,0.37,74,127,0.583,0.57,66,86,0.767,30,76,106,36,9,5,27,51,334
Chris Paul,PG,36,PHO,65,65,2139,363,736,0.493,63,199,0.317,300,537,0.559,0.536,169,202,0.837,22,261,283,702,121,20,153,134,958
Cameron Payne,PG,27,PHO,58,12,1278,240,587,0.409,71,211,0.336,169,376,0.449,0.469,75,89,0.843,24,151,175,282,40,17,103,119,626
Elfrid Payton,PG,27,PHO,50,1,549,67,175,0.383,4,18,0.222,63,157,0.401,0.394,12,32,0.375,21,67,88,99,25,6,47,38,150
Gary Payton II,SG,29,GSW,71,16,1247,212,344,0.616,43,120,0.358,169,224,0.754,0.679,35,58,0.603,72,175,247,64,96,22,40,131,502
Norvel Pelle,C,28,UTA,3,0,19,3,5,0.6,0,0,0,3,5,0.6,0.6,0,0,0,3,3,6,0,0,1,2,1,6
Reggie Perry,PF,21,TOT,10,1,187,40,79,0.506,3,16,0.188,37,63,0.587,0.525,9,15,0.6,15,32,47,12,9,6,11,33,92
Jamorko Pickett,PF,24,DET,13,0,176,18,50,0.36,13,39,0.333,5,11,0.455,0.49,1,2,0.5,6,26,32,7,0,7,5,12,50
Theo Pinson,SF,26,DAL,19,0,148,14,39,0.359,10,30,0.333,4,9,0.444,0.487,10,10,1,2,19,21,17,5,2,5,12,48
Mason Plumlee,C,31,CHO,73,73,1793,205,320,0.641,0,2,0,205,318,0.645,0.641,67,171,0.392,176,389,565,226,61,52,100,224,477
Jakob Poeltl,C,26,SAS,68,67,1970,410,663,0.618,1,1,1,409,662,0.618,0.619,94,190,0.495,262,372,634,189,45,118,109,212,915
Aleksej Pokusevski,PF,20,OKC,61,12,1233,186,456,0.408,57,197,0.289,129,259,0.498,0.47,35,50,0.7,73,245,318,131,39,38,94,88,464
Yves Pons,SF,22,MEM,12,0,71,5,16,0.313,3,9,0.333,2,7,0.286,0.406,0,2,0,5,7,12,1,1,4,1,6,13
Jordan Poole,SG,22,GSW,76,51,2283,474,1058,0.448,211,580,0.364,263,478,0.55,0.548,246,266,0.925,34,226,260,304,60,23,187,206,1405
Kevin Porter Jr.,PG,21,HOU,61,61,1907,335,808,0.415,155,413,0.375,180,395,0.456,0.511,124,193,0.642,43,224,267,376,69,22,192,156,949
Michael Porter Jr.,SF,23,DEN,9,9,265,37,103,0.359,10,48,0.208,27,55,0.491,0.408,5,9,0.556,9,50,59,17,10,2,12,16,89
Otto Porter Jr.,PF,28,GSW,63,15,1396,193,416,0.464,80,216,0.37,113,200,0.565,0.56,49,61,0.803,86,276,362,94,68,29,37,83,515
Bobby Portis,C,26,MIL,72,59,2028,417,871,0.479,133,338,0.393,284,533,0.533,0.555,85,113,0.752,180,477,657,86,53,51,90,174,1052
Kristaps Porziņģis,PF,26,TOT,51,51,1481,352,767,0.459,78,252,0.31,274,515,0.532,0.51,248,286,0.867,102,309,411,119,37,84,81,137,1030
Micah Potter,C,23,DET,3,0,31,5,11,0.455,0,2,0,5,9,0.556,0.455,2,2,1,4,5,9,0,1,1,1,4,12
Dwight Powell,C,30,DAL,82,71,1798,269,401,0.671,13,37,0.351,256,364,0.703,0.687,166,212,0.783,173,231,404,97,37,39,64,220,717
Myles Powell,PG,24,PHI,11,0,52,5,17,0.294,1,6,0.167,4,11,0.364,0.324,2,2,1,1,5,6,3,1,0,3,8,13
Norman Powell,SF-SG,28,TOT,45,41,1458,279,605,0.461,106,253,0.419,173,352,0.491,0.549,189,233,0.811,20,125,145,96,42,21,69,106,853
Joshua Primo,SF,19,SAS,50,16,965,101,270,0.374,42,137,0.307,59,133,0.444,0.452,44,59,0.746,32,81,113,81,20,23,57,79,288
Taurean Prince,PF,27,MIN,69,8,1177,177,390,0.454,86,229,0.376,91,161,0.565,0.564,62,82,0.756,26,148,174,68,47,23,53,116,502
Payton Pritchard,PG,24,BOS,71,2,1001,160,373,0.429,101,245,0.412,59,128,0.461,0.564,21,21,1,32,102,134,139,25,6,41,61,442
Trevelin Queen,SG,24,HOU,10,0,74,15,33,0.455,9,24,0.375,6,9,0.667,0.591,4,4,1,7,9,16,4,5,1,7,6,43
Neemias Queta,C,22,SAC,14,0,120,17,38,0.447,0,0,0,17,38,0.447,0.447,11,17,0.647,14,17,31,6,1,8,6,18,45
Immanuel Quickley,PG,22,NYK,78,3,1802,284,724,0.392,137,396,0.346,147,328,0.448,0.487,177,201,0.881,31,216,247,275,54,3,99,167,882
Jahmi'us Ramsey,SG,20,SAC,19,0,134,24,58,0.414,5,18,0.278,19,40,0.475,0.457,7,14,0.5,4,9,13,7,1,1,5,10,60
Julius Randle,PF,27,NYK,72,72,2544,512,1246,0.411,120,390,0.308,392,856,0.458,0.459,303,401,0.756,125,591,716,370,53,39,245,205,1447
Austin Reaves,SG,23,LAL,61,19,1418,146,318,0.459,53,167,0.317,93,151,0.616,0.542,99,118,0.839,45,148,193,110,29,20,40,87,444
Cam Reddish,SF,22,TOT,49,7,1012,165,408,0.404,66,184,0.359,99,224,0.442,0.485,101,112,0.902,25,80,105,48,47,15,57,60,497
Davon Reed,SG,26,DEN,48,5,668,81,161,0.503,37,86,0.43,44,75,0.587,0.618,10,15,0.667,14,94,108,53,24,9,16,63,209
Paul Reed,C,22,PHI,38,2,302,54,96,0.563,2,8,0.25,52,88,0.591,0.573,6,14,0.429,44,48,92,16,33,14,10,57,116
Naz Reid,C,22,MIN,77,6,1215,233,476,0.489,57,166,0.343,176,310,0.568,0.549,114,149,0.765,102,199,301,71,40,71,82,172,637
Nick Richards,C,24,CHO,50,5,367,60,90,0.667,0,0,0,60,90,0.667,0.667,30,43,0.698,34,52,86,13,9,21,24,51,150
Josh Richardson,SG,28,TOT,65,7,1600,234,534,0.438,102,246,0.415,132,288,0.458,0.534,96,108,0.889,42,143,185,115,56,29,66,116,666
Austin Rivers,SG,29,DEN,67,18,1480,146,350,0.417,79,231,0.342,67,119,0.563,0.53,32,44,0.727,19,95,114,90,51,6,54,121,403
Duncan Robinson,SG,27,MIA,79,68,2043,290,726,0.399,232,624,0.372,58,102,0.569,0.559,51,61,0.836,24,179,203,129,42,14,60,201,863
Justin Robinson,PG,24,TOT,25,0,304,28,93,0.301,18,61,0.295,10,32,0.313,0.398,4,8,0.5,4,17,21,32,9,1,17,27,78
Mitchell Robinson,C,23,NYK,72,62,1848,261,343,0.761,0,0,0,261,343,0.761,0.761,88,181,0.486,295,322,617,38,58,133,60,195,610
Jeremiah Robinson-Earl,C,21,OKC,49,36,1087,134,324,0.414,58,165,0.352,76,159,0.478,0.503,40,54,0.741,75,199,274,49,29,15,39,75,366
Isaiah Roby,PF,23,OKC,45,28,948,166,323,0.514,44,99,0.444,122,224,0.545,0.582,78,116,0.672,75,142,217,71,36,34,43,109,454
Rajon Rondo,PG,35,TOT,39,1,697,68,176,0.386,31,88,0.352,37,88,0.42,0.474,19,26,0.731,15,93,108,170,30,6,68,56,186
Derrick Rose,PG,33,NYK,26,4,636,122,274,0.445,37,92,0.402,85,182,0.467,0.513,30,31,0.968,21,57,78,103,22,12,39,15,311
Terrence Ross,SG,30,ORL,63,0,1448,220,554,0.397,77,264,0.292,143,290,0.493,0.467,112,130,0.862,20,141,161,116,28,12,75,68,629
Terry Rozier,SG,27,CHO,73,73,2458,518,1167,0.444,222,593,0.374,296,574,0.516,0.539,150,176,0.852,56,259,315,326,93,25,96,119,1408
Ricky Rubio,PG,31,CLE,34,8,970,149,411,0.363,59,174,0.339,90,237,0.38,0.434,88,103,0.854,15,126,141,225,49,7,90,75,445
D'Angelo Russell,PG,25,MIN,65,65,2077,401,975,0.411,176,518,0.34,225,457,0.492,0.502,198,240,0.825,25,191,216,460,62,22,165,130,1176
Matt Ryan,SF,24,BOS,1,0,5,1,5,0.2,1,5,0.2,0,0,0,0.3,0,0,0,0,0,0,0,1,0,0,0,3
Domantas Sabonis,PF-C,25,TOT,62,61,2136,443,773,0.573,39,125,0.312,404,648,0.623,0.598,246,332,0.741,201,551,752,323,59,27,195,203,1171
Olivier Sarr,C,22,OKC,22,2,421,58,101,0.574,13,29,0.448,45,72,0.625,0.639,24,29,0.828,34,59,93,19,6,15,22,52,153
Tomáš Satoranský,SG-PG-SF,30,TOT,55,13,906,72,191,0.377,11,53,0.208,61,138,0.442,0.406,43,54,0.796,27,99,126,184,29,5,46,71,198
Jordan Schakel,SG,23,WAS,4,0,30,1,11,0.091,1,6,0.167,0,5,0,0.136,2,2,1,2,6,8,0,1,0,1,0,5
Admiral Schofield,SF,24,ORL,38,1,469,54,129,0.419,26,79,0.329,28,50,0.56,0.519,12,15,0.8,17,72,89,25,4,5,21,58,146
Dennis Schröder,SG-PG,28,TOT,64,29,1837,312,724,0.431,86,250,0.344,226,474,0.477,0.49,157,184,0.853,34,180,214,296,53,8,143,154,867
Tre Scott,SF,25,CLE,2,0,11,3,6,0.5,0,1,0,3,5,0.6,0.5,0,0,0,1,1,2,0,1,1,0,2,6
Jay Scrubb,SG,21,LAC,18,0,121,18,46,0.391,6,21,0.286,12,25,0.48,0.457,7,10,0.7,2,14,16,8,4,3,7,9,49
Wayne Selden,SG,27,NYK,3,0,19,1,4,0.25,1,2,0.5,0,2,0,0.375,2,4,0.5,0,1,1,1,0,0,0,1,5
Alperen Şengün,C,19,HOU,72,13,1489,249,525,0.474,29,117,0.248,220,408,0.539,0.502,165,232,0.711,138,255,393,185,59,68,145,214,692
Collin Sexton,SG,23,CLE,11,11,316,68,151,0.45,11,45,0.244,57,106,0.538,0.487,29,39,0.744,13,23,36,23,10,0,31,25,176
Landry Shamet,SG,24,PHO,69,14,1437,191,485,0.394,123,334,0.368,68,151,0.45,0.521,68,81,0.84,16,110,126,108,28,9,41,92,573
Day'Ron Sharpe,PF,20,BRK,32,8,391,86,149,0.577,2,7,0.286,84,142,0.592,0.584,24,41,0.585,81,79,160,17,10,15,30,60,198
Pascal Siakam,PF,27,TOR,68,68,2578,596,1207,0.494,75,218,0.344,521,989,0.527,0.525,284,379,0.749,128,452,580,360,85,42,181,225,1551
Chris Silva,PF,25,TOT,10,0,91,8,15,0.533,0,0,0,8,15,0.533,0.533,10,12,0.833,13,23,36,7,0,1,8,20,26
Marko Simonovic,C,22,CHI,9,0,35,4,15,0.267,1,5,0.2,3,10,0.3,0.3,8,11,0.727,5,5,10,0,1,1,2,6,17
Anfernee Simons,SG,22,POR,57,30,1681,353,797,0.443,179,442,0.405,174,355,0.49,0.555,103,116,0.888,26,125,151,221,30,6,115,110,988
Zavier Simpson,PG,24,OKC,4,4,174,19,52,0.365,1,8,0.125,18,44,0.409,0.375,5,5,1,2,19,21,30,5,4,10,15,44
Jericho Sims,PF,23,NYK,41,5,555,39,54,0.722,0,0,0,39,54,0.722,0.722,12,29,0.414,61,108,169,21,11,22,20,66,90
Deividas Sirvydis,SG,21,DET,3,0,27,1,10,0.1,1,7,0.143,0,3,0,0.15,0,0,0,0,6,6,1,3,1,0,4,3
Javonte Smart,PG,22,TOT,17,1,200,19,60,0.317,8,27,0.296,11,33,0.333,0.383,5,6,0.833,5,19,24,16,6,3,11,12,51
Marcus Smart,PG,27,BOS,71,71,2296,300,718,0.418,119,360,0.331,181,358,0.506,0.501,142,179,0.793,42,228,270,417,119,18,159,160,861
Dennis Smith Jr.,PG,24,POR,37,4,638,79,189,0.418,6,27,0.222,73,162,0.451,0.434,42,64,0.656,20,68,88,132,45,12,51,52,206
Ish Smith,PG,33,TOT,65,1,1126,185,430,0.43,25,67,0.373,160,363,0.441,0.459,15,24,0.625,25,115,140,244,47,23,78,78,410
Jalen Smith,PF,21,TOT,51,8,925,176,350,0.503,40,122,0.328,136,228,0.596,0.56,78,102,0.765,101,206,307,24,15,41,42,96,470
Xavier Sneed,SF,24,TOT,9,0,39,2,10,0.2,1,8,0.125,1,2,0.5,0.25,0,0,0,2,4,6,1,0,0,0,2,5
Tony Snell,SG,30,TOT,53,12,823,69,171,0.404,45,128,0.352,24,43,0.558,0.535,4,4,1,16,87,103,28,16,9,19,70,187
Jaden Springer,SG,19,PHI,2,0,6,1,1,1,0,0,0,1,1,1,1,0,0,0,1,1,2,0,0,2,1,0,2
Cassius Stanley,SG,22,DET,9,1,155,19,46,0.413,4,17,0.235,15,29,0.517,0.457,10,10,1,5,14,19,4,5,2,6,17,52
Nik Stauskas,SG,28,TOT,8,0,39,5,14,0.357,4,10,0.4,1,4,0.25,0.5,4,6,0.667,1,2,3,2,0,0,1,1,18
Lance Stephenson,PG-SG,31,TOT,46,1,814,147,323,0.455,27,90,0.3,120,233,0.515,0.497,63,80,0.788,12,115,127,165,24,4,72,96,384
Lamar Stevens,PF,24,CLE,63,13,1015,156,319,0.489,18,65,0.277,138,254,0.543,0.517,53,75,0.707,47,117,164,44,31,18,41,106,383
Isaiah Stewart,C,20,DET,71,71,1816,250,490,0.51,15,46,0.326,235,444,0.529,0.526,74,103,0.718,226,391,617,82,22,78,85,211,589
Max Strus,SF,25,MIA,68,16,1587,249,564,0.441,181,442,0.41,68,122,0.557,0.602,42,53,0.792,24,178,202,92,28,16,57,116,721
Jalen Suggs,PG,20,ORL,48,45,1307,198,548,0.361,42,196,0.214,156,352,0.443,0.4,126,163,0.773,26,145,171,209,59,19,143,142,564
Craig Sword,SG,28,WAS,3,0,19,3,4,0.75,0,1,0,3,3,1,0.75,0,0,0,0,0,0,1,4,0,1,7,6
Keifer Sykes,PG,28,IND,32,11,566,69,190,0.363,27,90,0.3,42,100,0.42,0.434,15,17,0.882,8,37,45,62,12,4,33,51,180
Jae'Sean Tate,PF,26,HOU,78,77,2056,363,729,0.498,63,202,0.312,300,527,0.569,0.541,130,184,0.707,135,285,420,222,72,41,139,286,919
Jayson Tatum,SF,23,BOS,76,76,2731,708,1564,0.453,230,651,0.353,478,913,0.524,0.526,400,469,0.853,85,524,609,334,75,49,217,174,2046
Terry Taylor,SG,22,IND,33,7,714,135,220,0.614,12,38,0.316,123,182,0.676,0.641,36,51,0.706,95,77,172,41,14,8,23,61,318
Garrett Temple,SG,35,NOP,59,16,1098,111,295,0.376,59,185,0.319,52,110,0.473,0.476,28,41,0.683,29,114,143,74,43,23,42,81,309
Emanuel Terry,PF,25,PHO,3,0,18,0,5,0,0,0,0,0,5,0,0,0,0,0,8,7,15,2,1,0,5,4,0
Tyrell Terry,PG,21,MEM,2,0,3,1,1,1,0,0,0,1,1,1,1,0,0,0,0,0,0,0,0,0,0,1,2
Jon Teske,C,24,MEM,3,0,8,0,1,0,0,0,0,0,1,0,0,0,2,0,0,2,2,1,1,0,0,1,0
Daniel Theis,C,29,TOT,47,27,977,151,291,0.519,33,107,0.308,118,184,0.641,0.576,49,72,0.681,59,169,228,41,20,31,46,111,384
Brodric Thomas,SG,25,BOS,12,0,60,8,18,0.444,2,9,0.222,6,9,0.667,0.5,3,5,0.6,2,8,10,11,1,1,6,7,21
Cam Thomas,SG,20,BRK,67,2,1176,218,503,0.433,47,174,0.27,171,329,0.52,0.48,87,105,0.829,16,145,161,78,33,8,55,66,570
Isaiah Thomas,PG,32,TOT,22,1,333,67,167,0.401,28,83,0.337,39,84,0.464,0.485,22,26,0.846,4,25,29,34,7,5,15,34,184
Matt Thomas,SG,27,CHI,40,0,459,55,134,0.41,35,91,0.385,20,43,0.465,0.541,16,20,0.8,3,47,50,20,8,3,8,18,161
Klay Thompson,SG,31,GSW,32,32,941,246,573,0.429,114,296,0.385,132,277,0.477,0.529,46,51,0.902,15,110,125,88,16,17,43,54,652
Tristan Thompson,PF,30,TOT,57,6,897,141,267,0.528,1,3,0.333,140,264,0.53,0.53,61,116,0.526,120,168,288,34,23,21,45,98,344
JT Thor,PF,19,CHO,33,0,262,24,55,0.436,7,27,0.259,17,28,0.607,0.5,12,20,0.6,11,32,43,19,8,11,10,26,67
Matisse Thybulle,SG,24,PHI,66,50,1685,150,300,0.5,45,144,0.313,105,156,0.673,0.575,34,43,0.791,42,109,151,75,115,71,39,158,379
Killian Tillie,C,23,MEM,36,3,461,43,127,0.339,27,86,0.314,16,41,0.39,0.445,5,8,0.625,21,39,60,22,23,15,13,58,118
Xavier Tillman Sr.,PF,23,MEM,53,2,701,98,216,0.454,10,49,0.204,88,167,0.527,0.477,46,71,0.648,66,95,161,62,49,15,34,63,252
Isaiah Todd,PF,20,WAS,12,0,74,7,26,0.269,4,16,0.25,3,10,0.3,0.346,2,6,0.333,3,9,12,4,4,2,4,4,20
Obi Toppin,PF,23,NYK,72,10,1230,251,473,0.531,52,169,0.308,199,304,0.655,0.586,94,124,0.758,69,199,268,77,25,33,56,102,648
Juan Toscano-Anderson,SF,28,GSW,73,6,994,115,235,0.489,28,87,0.322,87,148,0.588,0.549,40,70,0.571,28,148,176,127,48,17,68,115,298
Karl-Anthony Towns,C,26,MIN,74,74,2476,642,1214,0.529,150,366,0.41,492,848,0.58,0.591,384,467,0.822,194,533,727,269,72,83,226,267,1818
Gary Trent Jr.,SG,23,TOR,70,69,2448,450,1086,0.414,209,545,0.383,241,541,0.445,0.511,174,204,0.853,26,165,191,141,122,19,73,144,1283
P.J. Tucker,PF,36,MIA,71,70,1981,207,428,0.484,80,193,0.415,127,235,0.54,0.577,45,61,0.738,100,287,387,149,58,15,66,161,539
Rayjon Tucker,SG,24,TOT,5,0,71,6,9,0.667,4,5,0.8,2,4,0.5,0.889,5,7,0.714,3,5,8,10,4,0,1,5,21
Myles Turner,C,25,IND,42,42,1235,200,393,0.509,61,183,0.333,139,210,0.662,0.587,79,105,0.752,65,232,297,44,28,118,54,119,540
Jonas Valančiūnas,C,29,NOP,74,74,2240,510,938,0.544,57,158,0.361,453,780,0.581,0.574,237,289,0.82,226,617,843,190,41,60,179,247,1314
Denzel Valentine,SG,28,TOT,24,0,222,25,66,0.379,19,47,0.404,6,19,0.316,0.523,0,0,0,9,33,42,11,8,0,12,20,69
Jarred Vanderbilt,PF,22,MIN,74,67,1880,212,361,0.587,2,14,0.143,210,347,0.605,0.59,86,131,0.656,215,409,624,94,99,46,73,181,512
Fred VanVleet,PG,27,TOR,65,65,2462,442,1097,0.403,242,642,0.377,200,455,0.44,0.513,194,222,0.874,44,245,289,434,111,35,170,162,1320
Devin Vassell,SF,21,SAS,71,32,1937,326,764,0.427,137,380,0.361,189,384,0.492,0.516,83,99,0.838,44,262,306,136,76,41,58,143,872
Gabe Vincent,PG,25,MIA,68,27,1589,214,513,0.417,119,323,0.368,95,190,0.5,0.533,44,54,0.815,22,104,126,210,62,12,98,158,591
Nikola Vučević,C,31,CHI,73,73,2418,546,1154,0.473,104,331,0.314,442,823,0.537,0.518,92,121,0.76,142,662,804,236,70,71,136,181,1288
Dean Wade,PF,25,CLE,51,28,980,99,217,0.456,51,142,0.359,48,75,0.64,0.574,20,30,0.667,31,119,150,52,29,7,16,88,269
Franz Wagner,SF,20,ORL,79,79,2429,456,975,0.468,96,271,0.354,360,704,0.511,0.517,189,219,0.863,84,272,356,231,68,34,119,164,1197
Moritz Wagner,C,24,ORL,63,3,960,197,396,0.497,66,201,0.328,131,195,0.672,0.581,104,129,0.806,42,190,232,87,20,13,56,123,564
Ish Wainright,PF,27,PHO,45,0,359,41,104,0.394,19,59,0.322,22,45,0.489,0.486,7,12,0.583,27,27,54,15,20,6,13,49,108
Kemba Walker,PG,31,NYK,37,37,948,149,370,0.403,73,199,0.367,76,171,0.444,0.501,60,71,0.845,14,97,111,131,26,7,48,37,431
Lonnie Walker IV,SG,23,SAS,70,6,1612,311,764,0.407,111,353,0.314,200,411,0.487,0.48,116,148,0.784,18,163,181,152,44,19,71,98,849
M.J. Walker,SG,23,PHO,2,0,8,0,4,0,0,2,0,0,2,0,0,0,0,0,0,1,1,1,2,0,0,1,0
Tyrone Wallace,SG,27,NOP,6,0,75,7,20,0.35,2,8,0.25,5,12,0.417,0.4,1,5,0.2,0,8,8,1,3,1,2,7,17
Derrick Walton,PG,26,DET,3,3,108,6,26,0.231,3,13,0.231,3,13,0.231,0.288,4,4,1,2,8,10,21,7,4,11,8,19
Brad Wanamaker,PG,32,TOT,23,2,320,28,77,0.364,4,17,0.235,24,60,0.4,0.39,23,25,0.92,6,33,39,55,7,6,23,45,83
Duane Washington Jr.,PG,21,IND,48,7,968,173,427,0.405,81,215,0.377,92,212,0.434,0.5,46,61,0.754,4,79,83,85,26,3,57,66,473
P.J. Washington,C,23,CHO,65,28,1768,250,532,0.47,110,301,0.365,140,231,0.606,0.573,58,81,0.716,82,255,337,147,57,61,82,152,668
Yuta Watanabe,SF,27,TOR,38,4,445,56,138,0.406,27,79,0.342,29,59,0.492,0.504,24,40,0.6,18,74,92,21,11,16,19,38,163
Lindy Waters III,SG,24,OKC,25,1,465,71,175,0.406,53,146,0.363,18,29,0.621,0.557,4,5,0.8,6,67,73,24,19,8,11,31,199
Tremont Waters,PG,24,TOT,3,0,50,4,14,0.286,2,9,0.222,2,5,0.4,0.357,0,0,0,0,4,4,7,5,0,4,4,10
Trendon Watford,SF,21,POR,48,10,869,142,267,0.532,9,38,0.237,133,229,0.581,0.549,71,94,0.755,57,142,199,81,25,28,44,116,364
Paul Watson,SF,27,OKC,9,3,156,12,35,0.343,6,26,0.231,6,9,0.667,0.429,1,2,0.5,3,24,27,8,3,3,4,10,31
Quinndary Weatherspoon,SG,25,GSW,11,0,73,12,21,0.571,1,5,0.2,11,16,0.688,0.595,5,5,1,2,12,14,5,1,1,3,15,30
Russell Westbrook,PG,33,LAL,78,78,2678,548,1233,0.444,79,265,0.298,469,968,0.485,0.476,266,399,0.667,110,470,580,550,75,20,295,235,1441
Coby White,PG,21,CHI,61,17,1675,279,644,0.433,136,353,0.385,143,291,0.491,0.539,78,91,0.857,17,165,182,176,29,11,70,137,772
Derrick White,SG,27,TOT,75,52,2199,337,800,0.421,115,369,0.312,222,431,0.515,0.493,203,235,0.864,38,223,261,366,64,58,119,172,992
Hassan Whiteside,C,32,UTA,65,8,1162,215,330,0.652,0,0,0,215,330,0.652,0.652,104,167,0.623,166,328,494,26,22,103,53,179,534
Joe Wieskamp,SG,22,SAS,29,0,205,20,56,0.357,14,43,0.326,6,13,0.462,0.482,7,13,0.538,4,10,14,9,4,3,2,14,61
Aaron Wiggins,SG,23,OKC,50,35,1209,156,337,0.463,42,138,0.304,114,199,0.573,0.525,62,85,0.729,51,127,178,68,30,10,54,93,416
Andrew Wiggins,SF,26,GSW,73,73,2329,475,1019,0.466,157,399,0.393,318,620,0.513,0.543,149,235,0.634,85,240,325,161,76,51,111,158,1256
Lindell Wigginton,PG,23,MIL,19,0,199,26,61,0.426,9,26,0.346,17,35,0.486,0.5,19,35,0.543,3,22,25,23,5,1,12,17,80
Brandon Williams,PG,22,POR,24,16,640,105,282,0.372,31,106,0.292,74,176,0.42,0.427,68,97,0.701,19,55,74,94,24,10,58,52,309
Grant Williams,PF,23,BOS,77,21,1875,205,432,0.475,106,258,0.411,99,174,0.569,0.597,86,95,0.905,64,210,274,78,38,57,62,186,602
Kenrich Williams,SF,27,OKC,49,0,1072,146,317,0.461,41,121,0.339,105,196,0.536,0.525,30,55,0.545,75,145,220,108,44,10,46,81,363
Lou Williams,PG,35,ATL,56,0,799,125,320,0.391,37,102,0.363,88,218,0.404,0.448,67,78,0.859,16,71,87,105,28,3,43,48,354
Patrick Williams,PF,20,CHI,17,9,422,54,102,0.529,15,29,0.517,39,73,0.534,0.603,30,41,0.732,17,52,69,15,9,9,16,28,153
Robert Williams,C,24,BOS,61,61,1804,271,368,0.736,0,1,0,271,367,0.738,0.736,65,90,0.722,238,350,588,121,56,134,63,137,607
Ziaire Williams,SF,20,MEM,62,31,1346,191,424,0.45,76,242,0.314,115,182,0.632,0.54,43,55,0.782,26,103,129,65,35,12,41,113,501
D.J. Wilson,PF,25,TOR,4,1,54,11,15,0.733,0,2,0,11,13,0.846,0.733,8,10,0.8,1,15,16,5,5,1,2,6,30
Dylan Windler,SF,25,CLE,50,0,459,37,98,0.378,21,70,0.3,16,28,0.571,0.485,15,18,0.833,21,68,89,34,14,3,16,47,110
Justise Winslow,PF,25,TOT,48,11,774,110,257,0.428,15,66,0.227,95,191,0.497,0.457,39,66,0.591,50,152,202,84,35,25,49,67,274
Cassius Winston,PG,23,WAS,7,0,39,4,11,0.364,2,6,0.333,2,5,0.4,0.455,4,4,1,0,1,1,7,0,0,3,9,14
Christian Wood,C,26,HOU,68,67,2094,440,878,0.501,131,336,0.39,309,542,0.57,0.576,207,332,0.623,110,576,686,155,54,65,126,171,1218
Robert Woodard II,SF,22,SAC,12,0,42,2,16,0.125,1,4,0.25,1,12,0.083,0.156,2,2,1,5,6,11,3,1,1,1,3,7
Delon Wright,SG,29,ATL,77,8,1452,122,269,0.454,44,116,0.379,78,153,0.51,0.535,54,63,0.857,50,170,220,188,93,19,45,56,342
McKinley Wright IV,PG,23,MIN,5,0,19,2,3,0.667,1,2,0.5,1,1,1,0.833,0,0,0,0,0,0,3,0,0,1,1,5
Moses Wright,PF,23,TOT,4,0,14,1,4,0.25,0,1,0,1,3,0.333,0.25,3,3,1,1,2,3,2,0,1,0,0,5
Gabe York,SG,28,IND,2,0,21,2,7,0.286,1,6,0.167,1,1,1,0.357,3,5,0.6,0,2,2,4,2,1,1,4,8
Thaddeus Young,PF,33,TOT,52,1,845,141,272,0.518,17,48,0.354,124,224,0.554,0.55,23,49,0.469,80,128,208,104,54,18,52,81,322
Trae Young,PG,23,ATL,76,76,2652,711,1544,0.46,233,610,0.382,478,934,0.512,0.536,500,553,0.904,50,234,284,737,72,7,303,128,2155
Omer Yurtseven,C,23,MIA,56,12,706,130,247,0.526,1,11,0.091,129,236,0.547,0.528,38,61,0.623,85,209,294,49,17,20,41,84,299
Cody Zeller,C,29,POR,27,0,355,51,90,0.567,0,4,0,51,86,0.593,0.567,38,49,0.776,50,75,125,22,8,6,19,56,140
Ivica Zubac,C,24,LAC,76,76,1852,310,495,0.626,0,0,0,310,495,0.626,0.626,165,227,0.727,217,427,644,120,36,77,114,203,785
